'γω	ɣ o 
'χω	x o 
'σαι	s ɛ 
'ταν	t̪ ɐ n̪ 
'βαλα	v ɐ l ɐ 
'θελε	θ ɛ l ɛ 
'χάσε	x ɐ s ɛ 
'χουν	x u n̪ 
'λεγες	l ɛ ɣ ɛ s 
'ξερες	k s ɛ ɾ ɛ s 
'σπαζαν	s p ɐ z ɐ n̪ 
'στριψε	s t̪ ɾ i p s ɛ 
'ρχόσουν	ɾ x o s u n̪ 
Aπό	ɐ p o 
Mπορούν	m p o ɾ u n̪ 
Oι	o i 
Tι	t̪ i 
Tρεχάτος	t̪ ɾ ɛ x ɐ t̪ o s 
´ναι	n̪ ɛ 
´παιρνε	p ɛ ɾ n̪ ɛ 
hangover	ɐ n̪ ɡ o v ɾ 
Ή	i 
Ό	o 
Α	ɐ 
Ε	ɛ 
Η	i 
Ο	o 
Ω	o 
ή	i 
ε	ɛ 
η	i 
ο	o 
Α'	ɐ 
Θ'	θ 
Μ'	m 
Ν'	n̪ 
Σ'	s 
Τ'	t̪ 
θ'	θ 
κ'	k 
μ'	m 
ν'	n̪ 
σ'	s 
τ'	t̪ 
Αμ	ɐ m 
Αν	ɐ n̪ 
Ας	ɐ s 
Αχ	ɐ x 
Δε	ð ɛ 
Θα	θ ɐ 
Κι	k i 
Μα	m ɐ 
Με	m ɛ 
Μη	m i 
Να	n̪ ɐ 
Οι	i 
Ρε	ɾ ɛ 
Σα	s ɐ 
Σε	s ɛ 
Τί	t̪ i 
Τα	t̪ ɐ 
Τη	t̪ i 
Τι	t̪ i 
Το	t̪ o 
Ως	o s 
αν	ɐ n̪ 
ας	ɐ s 
γη	ɣ i 
δα	ð ɐ 
δε	ð ɛ 
δω	ð o 
ζω	z o 
θα	θ ɐ 
κι	k i 
κ’	k 
μα	m ɐ 
με	m ɛ 
μη	m i 
μ’	m 
να	n̪ ɐ 
οι	i 
πα	p ɐ 
πω	p o 
σα	s ɐ 
σε	s ɛ 
συ	s i 
τα	t̪ ɐ 
τη	t̪ i 
τι	t̪ i 
το	t̪ o 
τω	t̪ o 
ως	o s 
γι	ɣ i 
́αυτό	ɐ f t̪ o 
Αμ'	ɐ m 
Απ'	ɐ p 
Γι'	ɣ i 
απ'	ɐ p 
γι'	ɣ i 
ολ'	o l 
στ'	s t̪ 
όλ'	o l 
Άσε	ɐ s ɛ 
Έλα	ɛ l ɐ 
Ένα	ɛ n̪ ɐ 
Έξω	ɛ k s o 
Έχε	ɛ x ɛ 
Έχω	ɛ x o 
Ίσα	i s ɐ 
Όλα	o l ɐ 
Όλη	o l i 
Όλο	o l o 
Όσα	o s ɐ 
Όσο	o s o 
Ότι	o t̪ i 
Όχι	o x i 
Αμέ	ɐ m ɛ 
Από	ɐ p o 
Για	ɣ i ɐ 
Δεν	ð ɛ n̪ 
Δες	ð ɛ s 
Δυο	ð i o 
Δύο	ð i o 
Εγώ	ɛ ɣ o 
Εδώ	ɛ ð o 
Ενώ	ɛ n̪ o 
Εσύ	ɛ s i 
Θες	θ ɛ s 
Θεό	θ ɛ o 
Και	k ɛ 
Λες	l ɛ s 
Μία	m i ɐ 
Μας	m ɐ s 
Μην	m i n̪ 
Μια	m i ɐ 
Μου	m u 
Μπα	b ɐ 
Ναι	n̪ ɛ 
Παν	p ɐ n̪ 
Πας	p ɐ s 
Πες	p ɛ s 
Πια	p i ɐ 
Πού	p u 
Πως	p o s 
Πώς	p o s 
Σαν	s ɐ n̪ 
Σου	s u 
Στα	s t̪ ɐ 
Στη	s t̪ i 
Στο	s t̪ o 
Την	t̪ i n̪ 
Της	t̪ i s 
Τον	t̪ o n̪ 
Του	t̪ u 
έλα	ɛ l ɐ 
ένα	ɛ n̪ ɐ 
έξι	ɛ k s i 
έξω	ɛ k s o 
έχω	ɛ x o 
ήδη	i ð i 
ίσο	i s o 
αμέ	ɐ m ɛ 
από	ɐ p o 
απ’	ɐ p 
βία	v i ɐ 
βρω	v ɾ o 
γης	ɣ i s 
για	ɣ i ɐ 
γιε	ɣ i ɛ 
γιο	ɣ i o 
γι’	ɣ i 
δει	ð i 
δεν	ð ɛ n̪ 
δες	ð ɛ s 
δυο	ð i o 
δύο	ð i o 
εάν	ɛ ɐ n̪ 
εγώ	ɛ ɣ o 
εδώ	ɛ ð o 
ενώ	ɛ n̪ o 
εσυ	ɛ s i 
εσύ	ɛ s i 
ζει	z i 
ζωή	z o i 
ζώα	z o ɐ 
ζώο	z o 
θες	θ ɛ s 
θεώ	θ ɛ o 
ιδώ	i ð o 
και	k ɛ 
καν	k ɐ n̪ 
κει	k i 
κυρ	k i ɾ 
λέω	l ɛ o 
λαό	l ɐ o 
λεν	l ɛ n̪ 
λες	l ɛ s 
μάς	m ɐ s 
μία	m i ɐ 
μας	m ɐ s 
μες	m ɛ s 
μην	m i n̪ 
μια	m i ɐ 
μου	m u 
μού	m u 
νέα	n̪ ɛ ɐ 
νέο	n̪ ɛ o 
ναι	n̪ ɛ 
νου	n̪ u 
οκά	o k ɐ 
πάω	p ɐ o 
παν	p ɐ n̪ 
πας	p ɐ s 
πει	p i 
πες	p ɛ s 
πια	p i ɐ 
πιο	p i o 
που	p u 
πού	p u 
πως	p o s 
πώς	p o s 
σαν	s ɐ n̪ 
σας	s ɐ s 
σου	s u 
στα	s t̪ ɐ 
στη	s t̪ i 
στο	s t̪ o 
στ’	s t̪ 
την	t̪ i n̪ 
της	t̪ i s 
τις	t̪ i s 
τον	t̪ o n̪ 
του	t̪ u 
τού	t̪ u 
των	t̪ o n̪ 
υπό	i p o 
φαν	f ɐ n̪ 
φας	f ɐ s 
φως	f o s 
όλα	o l ɐ 
όλη	o l i 
όλο	o l o 
όσα	o s ɐ 
όση	o s i 
όσο	o s o 
ότι	o t̪ i 
όχι	o x i 
ώμο	o m o 
ώρα	o ɾ ɐ 
‘χε	x ɛ 
Δωσ'	ð o s 
Δώσ'	ð o s 
Ούτ'	u t̪ 
Φερ'	f ɛ ɾ 
δωσ'	ð o s 
είν'	i n̪ 
μεσ'	m ɛ s 
ουτ'	u t̪ 
φέρ'	f ɛ ɾ 
φερ'	f ɛ ɾ 
Ίσα-ίσα	i s ɐ i s ɐ 
ένα-δυο	ɛ n̪ ɐ ð i o 
ίσα-ίσα	i s ɐ i s ɐ 
μια-μια	m i ɐ m i ɐ 
άνω-κάτω	ɐ n̪ o k ɐ t̪ o 
δυο-τρία	ð i o t̪ ɾ i ɐ 
δυο-τρεις	ð i o t̪ ɾ i s 
Κυρ-Λαγόκαρδε	k i ɾ l ɐ ɣ o k ɐ ɾ ð ɛ 
κυρ-Λαγόκαρδε	k i ɾ l ɐ ɣ o k ɐ ɾ ð ɛ 
κυρ-Λαγόκαρδο	k i ɾ l ɐ ɣ o k ɐ ɾ ð o 
κυρ-λογιότατε	k i ɾ l o ɣ i o t̪ ɐ t̪ ɛ 
κυρ-Αστόχαστου	k i ɾ ɐ s t̪ o x ɐ s t̪ u 
κυρ-Λαγόκαρδος	k i ɾ l ɐ ɣ o k ɐ ɾ ð o s 
κυρ-Λαγόκαρδου	k i ɾ l ɐ ɣ o k ɐ ɾ ð u 
κυρ-Πανουργάκου	k i ɾ p ɐ n̪ u ɾ ɣ ɐ k u 
κυρ-Κατεργαρίσκο	k i ɾ k ɐ t̪ ɛ ɾ ɣ ɐ ɾ i s k o 
κυρ-Κατρακυλάκος	k i ɾ k ɐ t̪ ɾ ɐ k i l ɐ k o s 
κυρ-Μασκαρόπουλος	k i ɾ m ɐ s k ɐ ɾ o p u l o s 
κυρ-αρχικαγκελάριος	k i ɾ ɐ ɾ x i k ɐ ɡ ɛ l ɐ ɾ i o s 
Άγιο	ɐ ɣ i o 
Άκου	ɐ k u 
Άλλα	ɐ l ɐ 
Άλλη	ɐ l i 
Άλλο	ɐ l o 
Έβγα	ɛ v ɣ ɐ 
Έβρε	ɛ v ɾ ɛ 
Έμπα	ɛ b ɐ 
Έναν	ɛ n̪ ɐ n̪ 
Ένας	ɛ n̪ ɐ s 
Έστω	ɛ s t̪ o 
Έτσι	ɛ t̪ s i 
Έχει	ɛ x i 
Ήλθε	i l θ ɛ 
Ήρθε	i ɾ θ ɛ 
Ήρωα	i ɾ o ɐ 
Ήταν	i t̪ ɐ n̪ 
Ίσια	i s i ɐ 
Ίσως	i s o s 
Όλες	o l ɛ s 
Όλοι	o l i 
Όλος	o l o s 
Όπλα	o p l ɐ 
Όπου	o p u 
Όπως	o p o s 
Όσοι	o s i 
Όταν	o t̪ ɐ n̪ 
Ώρες	o ɾ ɛ s 
Ώστε	o s t̪ ɛ 
Αλλά	ɐ l ɐ 
Αντί	ɐ d̪ i 
Απλά	ɐ p l ɐ 
Αυγά	ɐ v ɣ ɐ 
Αυτά	ɐ f t̪ ɐ 
Αυτή	ɐ f t̪ i 
Αυτό	ɐ f t̪ o 
Αφού	ɐ f u 
Βάλε	v ɐ l ɛ 
Γεια	ɣ i ɐ 
Γύρω	ɣ i ɾ o 
Δέκα	ð ɛ k ɐ 
Δέσε	ð ɛ s ɛ 
Δικά	ð i k ɐ 
Δόξα	ð o k s ɐ 
Δώσε	ð o s ɛ 
Είδα	i ð ɐ 
Είδε	i ð ɛ 
Είπε	i p ɛ 
Είχε	i x ɛ 
Εκεί	ɛ k i 
Ζήσε	z i s ɛ 
Ζήτω	z i t̪ o 
Ζωές	z o ɛ s 
Θάνο	θ ɐ n̪ o 
Θέλω	θ ɛ l o 
Θεού	θ ɛ u 
Θεός	θ ɛ o s 
Κάθε	k ɐ θ ɛ 
Κάνε	k ɐ n̪ ɛ 
Κάτι	k ɐ t̪ i 
Κάτω	k ɐ t̪ o 
Καλά	k ɐ l ɐ 
Καλέ	k ɐ l ɛ 
Καλή	k ɐ l i 
Καλό	k ɐ l o 
Κατά	k ɐ t̪ ɐ 
Κυρά	k i ɾ ɐ 
Λέγε	l ɛ ɣ ɛ 
Λέγω	l ɛ ɣ o 
Λίγα	l i ɣ ɐ 
Λίγη	l i ɣ i 
Λύσε	l i s ɛ 
Μάνα	m ɐ n̪ ɐ 
Μέσα	m ɛ s ɐ 
Μαζί	m ɐ z i 
Μετά	m ɛ t̪ ɐ 
Μιας	m i ɐ s 
Μπαμ	b ɐ m 
Μόνο	m o n̪ o 
Ξέρω	k s ɛ ɾ o 
Οταν	o t̪ ɐ n̪ 
Ούτε	u t̪ ɛ 
Πάλι	p ɐ l i 
Πάμε	p ɐ m ɛ 
Πάνω	p ɐ n̪ o 
Πάρε	p ɐ ɾ ɛ 
Πήγε	p i ɣ ɛ 
Πήδα	p i ð ɐ 
Πήρα	p i ɾ ɐ 
Πήρε	p i ɾ ɛ 
Πλάι	p l ɐ i 
Ποία	p i ɐ 
Ποια	p i ɐ 
Ποιο	p i o 
Ποτέ	p o t̪ ɛ 
Πριν	p ɾ i n̪ 
Πόσο	p o s o 
Πότε	p o t̪ ɛ 
Ράβω	ɾ ɐ v o 
Ρίξε	ɾ i k s ɛ 
Σήκω	s i k o 
Στην	s t̪ i n̪ 
Στον	s t̪ o n̪ 
Τους	t̪ u s 
Τόξο	t̪ o k s o 
Τόσα	t̪ o s ɐ 
Τόσο	t̪ o s o 
Τότε	t̪ o t̪ ɛ 
Τύχη	t̪ i x i 
Τώρα	t̪ o ɾ ɐ 
Φέρε	f ɛ ɾ ɛ 
Φαγί	f ɐ ɣ i 
Φύγε	f i ɣ ɛ 
Χάμω	x ɐ m o 
Χαρά	x ɐ ɾ ɐ 
Χθες	x θ ɛ s 
Ψήσε	p s i s ɛ 
άκρη	ɐ k ɾ i 
άλλα	ɐ l ɐ 
άλλη	ɐ l i 
άλλο	ɐ l o 
άλφα	ɐ l f ɐ 
άντε	ɐ d̪ ɛ 
άστα	ɐ s t̪ ɐ 
έλθω	ɛ l θ o 
έναν	ɛ n̪ ɐ n̪ 
ένας	ɛ n̪ ɐ s 
έρθω	ɛ ɾ θ o 
έρμη	ɛ ɾ m i 
έστω	ɛ s t̪ o 
έτσι	ɛ t̪ s i 
έχει	ɛ x i 
ήλθα	i l θ ɐ 
ήλθε	i l θ ɛ 
ήλιο	i l i o 
ήρθα	i ɾ θ ɐ 
ήταν	i t̪ ɐ n̪ 
ήχος	i x o s 
ίδια	i ð i ɐ 
ίδιο	i ð i o 
ίσια	i s i ɐ 
ίσως	i s o s 
αέρα	ɐ ɛ ɾ ɐ 
αίμα	ɛ m ɐ 
αθώο	ɐ θ o 
αλλά	ɐ l ɐ 
αντί	ɐ d̪ i 
αξία	ɐ k s i ɐ 
απλά	ɐ p l ɐ 
απλή	ɐ p l i 
απλό	ɐ p l o 
απών	ɐ p o n̪ 
αργά	ɐ ɾ ɣ ɐ 
αργό	ɐ ɾ ɣ o 
αρχή	ɐ ɾ x i 
αυγά	ɐ v ɣ ɐ 
αυγή	ɐ v ɣ i 
αυλή	ɐ v l i 
αυτά	ɐ f t̪ ɐ 
αυτή	ɐ f t̪ i 
αυτί	ɐ f t̪ i 
αυτό	ɐ f t̪ o 
αφού	ɐ f u 
αύτη	ɐ f t̪ i 
βάζω	v ɐ z o 
βάλε	v ɐ l ɛ 
βάλω	v ɐ l o 
βάση	v ɐ s i 
βέλη	v ɛ l i 
βήμα	v i m ɐ 
βαθύ	v ɐ θ i 
βαρύ	v ɐ ɾ i 
βγει	v ɣ i 
βρει	v ɾ i 
γάλα	ɣ ɐ l ɐ 
γάτα	ɣ ɐ t̪ ɐ 
γέρο	ɣ ɛ ɾ o 
γεια	ɣ i ɐ 
γερά	ɣ ɛ ɾ ɐ 
γερο	ɣ ɛ ɾ o 
γερό	ɣ ɛ ɾ o 
γιος	ɣ i o s 
γιου	ɣ i u 
γιός	ɣ i o s 
γριά	ɣ ɾ i ɐ 
γύρο	ɣ i ɾ o 
γύρω	ɣ i ɾ o 
δάση	ð ɐ s i 
δέκα	ð ɛ k ɐ 
δέμα	ð ɛ m ɐ 
δίκη	ð i k i 
δίνω	ð i n̪ o 
δαδί	ð ɐ ð i 
δεις	ð i s 
δικά	ð i k ɐ 
δική	ð i k i 
δικό	ð i k o 
δουν	ð u n̪ 
δόξα	ð o k s ɐ 
δύση	ð i s i 
δώμα	ð o m ɐ 
δώρο	ð o ɾ o 
δώσε	ð o s ɛ 
δώσω	ð o s o 
είδα	i ð ɐ 
είδε	i ð ɛ 
είπα	i p ɐ 
είπε	i p ɛ 
είτε	i t̪ ɛ 
είχα	i x ɐ 
είχε	i x ɛ 
εκεί	ɛ k i 
εκει	ɛ k i 
εμάς	ɛ m ɐ s 
ενός	ɛ n̪ o s 
εξής	ɛ k s i s 
ευχή	ɛ f x i 
ζήλο	z i l o 
ζήσε	z i s ɛ 
ζήσω	z i s o 
ζητά	z i t̪ ɐ 
ζητώ	z i t̪ o 
ζουν	z u n̪ 
ζωές	z o ɛ s 
ζωής	z o i s 
ζώνη	z o n̪ i 
θέλω	θ ɛ l o 
θέση	θ ɛ s i 
θέτε	θ ɛ t̪ ɛ 
θήκη	θ i k i 
θείο	θ i o 
θυμό	θ i m o 
ιδέα	i ð ɛ ɐ 
ιερά	i ɛ ɾ ɐ 
ιερό	i ɛ ɾ o 
κάθε	k ɐ θ ɛ 
κάμω	k ɐ m o 
κάνα	k ɐ n̪ ɐ 
κάνε	k ɐ n̪ ɛ 
κάνω	k ɐ n̪ o 
κάτι	k ɐ t̪ i 
κάτω	k ɐ t̪ o 
κάψα	k ɐ p s ɐ 
κέφι	k ɛ f i 
κήπο	k i p o 
κακά	k ɐ k ɐ 
κακό	k ɐ k o 
καλά	k ɐ l ɐ 
καλέ	k ɐ l ɛ 
καλή	k ɐ l i 
καλό	k ɐ l o 
κατά	k ɐ t̪ ɐ 
καφέ	k ɐ f ɛ 
κενά	k ɛ n̪ ɐ 
κερί	k ɛ ɾ i 
κιλά	k i l ɐ 
κρύο	k ɾ i o 
κυρά	k i ɾ ɐ 
κόβω	k o v o 
κόπο	k o p o 
κόρη	k o ɾ i 
κότα	k o t̪ ɐ 
κόψε	k o p s ɛ 
κόψω	k o p s o 
λέγω	l ɛ ɣ o 
λέει	l ɛ i 
λέμε	l ɛ m ɛ 
λένε	l ɛ n̪ ɛ 
λέξη	l ɛ k s i 
λήψη	l i p s i 
λίγα	l i ɣ ɐ 
λίγη	l i ɣ i 
λίγο	l i ɣ o 
λαγό	l ɐ ɣ o 
λαός	l ɐ o s 
λεκέ	l ɛ k ɛ 
λόγο	l o ɣ o 
λόγω	l o ɣ o 
λύπη	l i p i 
λύση	l i s i 
μάθε	m ɐ θ ɛ 
μάθω	m ɐ θ o 
μάνα	m ɐ n̪ ɐ 
μάτι	m ɐ t̪ i 
μάχη	m ɐ x i 
μέλι	m ɛ l i 
μένα	m ɛ n̪ ɐ 
μέρα	m ɛ ɾ ɐ 
μέρη	m ɛ ɾ i 
μέσα	m ɛ s ɐ 
μέση	m ɛ s i 
μήλα	m i l ɐ 
μήνα	m i n̪ ɐ 
μήτε	m i t̪ ɛ 
μίαν	m i ɐ n̪ 
μαζί	m ɐ z i 
μείς	m i s 
μετά	m ɛ t̪ ɐ 
μιαν	m i ɐ n̪ 
μιας	m i ɐ s 
μιλά	m i l ɐ 
μισά	m i s ɐ 
μισό	m i s o 
μόνη	m o n̪ i 
μόνο	m o n̪ o 
μύτη	m i t̪ i 
νέοι	n̪ ɛ i 
νέον	n̪ ɛ o n̪ 
νέος	n̪ ɛ o s 
νέου	n̪ ɛ u 
νήμα	n̪ i m ɐ 
νίκη	n̪ i k i 
νερά	n̪ ɛ ɾ ɐ 
νερό	n̪ ɛ ɾ o 
νησί	n̪ i s i 
νωπό	n̪ o p o 
ξένα	k s ɛ n̪ ɐ 
ξένο	k s ɛ n̪ o 
ξέρω	k s ɛ ɾ o 
ξερό	k s ɛ ɾ o 
ξηρά	k s i ɾ ɐ 
ξύλα	k s i l ɐ 
ξύλο	k s i l o 
οκτώ	o k t̪ o 
ορμή	o ɾ m i 
ουρά	u ɾ ɐ 
ούτε	u t̪ ɛ 
πάει	p ɐ i 
πάλη	p ɐ l i 
πάλι	p ɐ l i 
πάμε	p ɐ m ɛ 
πάνε	p ɐ n̪ ɛ 
πάνω	p ɐ n̪ o 
πάρα	p ɐ ɾ ɐ 
πάρε	p ɐ ɾ ɛ 
πάρω	p ɐ ɾ o 
πάτε	p ɐ t̪ ɛ 
πάτο	p ɐ t̪ o 
πέρα	p ɛ ɾ ɐ 
πήγα	p i ɣ ɐ 
πήγε	p i ɣ ɛ 
πήδο	p i ð o 
πήρα	p i ɾ ɐ 
πήρε	p i ɾ ɛ 
πίσω	p i s o 
πανί	p ɐ n̪ i 
παρά	p ɐ ɾ ɐ 
πεζή	p ɛ z i 
πεις	p i s 
πλάι	p l ɐ i 
ποια	p i ɐ 
ποιο	p i o 
πολύ	p o l i 
πονώ	p o n̪ o 
ποτέ	p o t̪ ɛ 
πουν	p u n̪ 
πριν	p ɾ i n̪ 
προς	p ɾ o s 
πρωί	p ɾ o i 
πόδι	p o ð i 
πόθο	p o θ o 
πόλη	p o l i 
πόνο	p o n̪ o 
πόσα	p o s ɐ 
πόση	p o s i 
πόσο	p o s o 
πότε	p o t̪ ɛ 
ράχη	ɾ ɐ x i 
ρίζα	ɾ i z ɐ 
ρωτώ	ɾ o t̪ o 
ρόδα	ɾ o ð ɐ 
ρύζι	ɾ i z i 
ρώτα	ɾ o t̪ ɐ 
σάκο	s ɐ k o 
σένα	s ɛ n̪ ɐ 
σεις	s i s 
σιγά	s i ɣ ɐ 
σιμά	s i m ɐ 
σκιά	s k i ɐ 
σοφά	s o f ɐ 
στην	s t̪ i n̪ 
στις	s t̪ i s 
στον	s t̪ o n̪ 
στου	s t̪ u 
σωρό	s o ɾ o 
σώμα	s o m ɐ 
σώσω	s o s o 
τάξη	t̪ ɐ k s i 
τάφο	t̪ ɐ f o 
τάχα	t̪ ɐ x ɐ 
ταψί	t̪ ɐ p s i 
τους	t̪ u s 
τρία	t̪ ɾ i ɐ 
τρως	t̪ ɾ o s 
τσάι	t̪ s ɐ i 
τόνο	t̪ o n̪ o 
τόξα	t̪ o k s ɐ 
τόξο	t̪ o k s o 
τόπο	t̪ o p o 
τόσα	t̪ o s ɐ 
τόση	t̪ o s i 
τόσο	t̪ o s o 
τότε	t̪ o t̪ ɛ 
τύχη	t̪ i x i 
τώρα	t̪ o ɾ ɐ 
φάγω	f ɐ ɣ o 
φάει	f ɐ i 
φάμε	f ɐ m ɛ 
φάνε	f ɐ n̪ ɛ 
φέρε	f ɛ ɾ ɛ 
φέρω	f ɛ ɾ o 
φέτα	f ɛ t̪ ɐ 
φίλε	f i l ɛ 
φίλη	f i l i 
φίλο	f i l o 
φαγί	f ɐ ɣ i 
φανώ	f ɐ n̪ o 
φιλί	f i l i 
φορά	f o ɾ ɐ 
φυγή	f i ɣ i 
φυτό	f i t̪ o 
φωνή	f o n̪ i 
φόβο	f o v o 
φύγε	f i ɣ ɛ 
φύγω	f i ɣ o 
φύση	f i s i 
φώτα	f o t̪ ɐ 
χάμω	x ɐ m o 
χάος	x ɐ o s 
χάρη	x ɐ ɾ i 
χάσω	x ɐ s o 
χέρι	x ɛ ɾ i 
χαλί	x ɐ l i 
χαρά	x ɐ ɾ ɐ 
χαρώ	x ɐ ɾ o 
χθες	x θ ɛ s 
χωνί	x o n̪ i 
χώμα	x o m ɐ 
χώνω	x o n̪ o 
χώρα	x o ɾ ɐ 
χώρο	x o ɾ o 
χώσω	x o s o 
ψήσω	p s i s o 
ψαρά	p s ɐ ɾ ɐ 
ψηλά	p s i l ɐ 
ψηλό	p s i l o 
ψυχή	p s i x i 
ψωμί	p s o m i 
όλες	o l ɛ s 
όλοι	o l i 
όλον	o l o n̪ 
όλος	o l o s 
όλου	o l u 
όλων	o l o n̪ 
όμως	o m o s 
όπλα	o p l ɐ 
όπλο	o p l o 
όπου	o p u 
όπως	o p o s 
όρκο	o ɾ k o 
όσοι	o s i 
όταν	o t̪ ɐ n̪ 
όχθη	o x θ i 
ύπνο	i p n̪ o 
ύφος	i f o s 
ώμοι	o m i 
ώραν	o ɾ ɐ n̪ 
ώρες	o ɾ ɛ s 
ώστε	o s t̪ ɛ 
’χει	x i 
Πρωί-πρωί	p ɾ o i p ɾ o i 
αργά-αργά	ɐ ɾ ɣ ɐ ɾ ɣ ɐ 
καλά-καλά	k ɐ l ɐ k ɐ l ɐ 
λίγα-λίγα	l i ɣ ɐ l i ɣ ɐ 
παχύ-παχύ	p ɐ x i p ɐ x i 
πρωί-πρωί	p ɾ o i p ɾ o i 
μέρα-νύχτα	m ɛ ɾ ɐ n̪ i x t̪ ɐ 
γερο-Συνετού	ɣ ɛ ɾ o s i n̪ ɛ t̪ u 
γερο-Συνετός	ɣ ɛ ɾ o s i n̪ ɛ t̪ o s 
κυρα-Φρόνηση	k i ɾ ɐ f ɾ o n̪ i s i 
γερο-Βασιλιάς	ɣ ɛ ɾ o v ɐ s i l i ɐ s 
γερο-Φτωχούλη	ɣ ɛ ɾ o f t̪ o x u l i 
γερο-πλάτανος	ɣ ɛ ɾ o p l ɐ t̪ ɐ n̪ o s 
κυρα-Φρόνησης	k i ɾ ɐ f ɾ o n̪ i s i s 
Γερο-Κακομοίρη	ɣ ɛ ɾ o k ɐ k o m i ɾ i 
γερο-Κακομοίρη	ɣ ɛ ɾ o k ɐ k o m i ɾ i 
γερο-φρούραρχο	ɣ ɛ ɾ o f ɾ u ɾ ɐ ɾ x o 
γερο-Κακομοίρης	ɣ ɛ ɾ o k ɐ k o m i ɾ i s 
γερο-φρούραρχου	ɣ ɛ ɾ o f ɾ u ɾ ɐ ɾ x u 
γερο-Κακομοιρίδη	ɣ ɛ ɾ o k ɐ k o m i ɾ i ð i 
κυρα-Βασιλοπούλα	k i ɾ ɐ v ɐ s i l o p u l ɐ 
Άγιος	ɐ ɣ i o s 
Άλλοι	ɐ l i 
Άλλον	ɐ l o n̪ 
Άλλος	ɐ l o s 
Άλογο	ɐ l o ɣ o 
Άναψε	ɐ n̪ ɐ p s ɛ 
Άφησε	ɐ f i s ɛ 
Έβαλε	ɛ v ɐ l ɛ 
Έγινε	ɛ ɣ i n̪ ɛ 
Έκανα	ɛ k ɐ n̪ ɐ 
Έκανε	ɛ k ɐ n̪ ɛ 
Έπεσε	ɛ p ɛ s ɛ 
Έραψα	ɛ ɾ ɐ p s ɐ 
Έφαγε	ɛ f ɐ ɣ ɛ 
Έφυγε	ɛ f i ɣ ɛ 
Έχασε	ɛ x ɐ s ɛ 
Έχεις	ɛ x i s 
Έχετε	ɛ x ɛ t̪ ɛ 
Έχομε	ɛ x o m ɛ 
Έχουν	ɛ x u n̪ 
Ήθελα	i θ ɛ l ɐ 
Ήξερα	i k s ɛ ɾ ɐ 
Ήξερε	i k s ɛ ɾ ɛ 
Ήσουν	i s u n̪ 
Ήσυχα	i s i x ɐ 
Όνομα	o n̪ o m ɐ 
Ακούς	ɐ k u s 
Ακόμη	ɐ k o m i 
Αλλού	ɐ l u 
Αυτές	ɐ f t̪ ɛ s 
Αυτός	ɐ f t̪ o s 
Αύριο	ɐ v ɾ i o 
Βάλτε	v ɐ l t̪ ɛ 
Βγάλε	v ɣ ɐ l ɛ 
Βγήκε	v ɣ i k ɛ 
Βλέπω	v l ɛ p o 
Βουτά	v u t̪ ɐ 
Βρήκε	v ɾ i k ɛ 
Γιατί	ɣ i ɐ t̪ i 
Γνώση	ɣ n̪ o s i 
Γράφε	ɣ ɾ ɐ f ɛ 
Δήμου	ð i m u 
Δίκιο	ð i k i o 
Δείξε	ð i k s ɛ 
Δώστε	ð o s t̪ ɛ 
Είμαι	i m ɛ 
Είναι	i n̪ ɛ 
Είσαι	i s ɛ 
Είστε	i s t̪ ɛ 
Είχες	i x ɛ s 
Ελάτε	ɛ l ɐ t̪ ɛ 
Ελάφι	ɛ l ɐ f i 
Εμείς	ɛ m i s 
Εσένα	ɛ s ɛ n̪ ɐ 
Εσείς	ɛ s i s 
Ευθύς	ɛ f θ i s 
Ζήλιω	z i l i o 
Θάνος	θ ɐ n̪ o s 
Θεωρώ	θ ɛ o ɾ o 
Κάνει	k ɐ n̪ i 
Κάπως	k ɐ p o s 
Καθώς	k ɐ θ o s 
Καλώς	k ɐ l o s 
Καμία	k ɐ m i ɐ 
Καμιά	k ɐ m i ɐ 
Κοντά	k o d̪ ɐ 
Κρίμα	k ɾ i m ɐ 
Κύριε	k i ɾ i ɛ 
Μένει	m ɛ n̪ i 
Μήπως	m i p o s 
Μήτσο	m i t̪ s o 
Μαξίμ	m ɐ k s i m 
Μαρία	m ɐ ɾ i ɐ 
Μιλάς	m i l ɐ s 
Μπήκε	b i k ɛ 
Μόλις	m o l i s 
Μόνες	m o n̪ ɛ s 
Μόνος	m o n̪ o s 
Ξέρει	k s ɛ ɾ i 
Ξύπνα	k s i p n̪ ɐ 
Πήγαν	p i ɣ ɐ n̪ 
Πήραν	p i ɾ ɐ n̪ 
Παίξε	p ɛ k s ɛ 
Παιδί	p ɛ ð i 
Παρών	p ɐ ɾ o n̪ 
Πιάσε	p i ɐ s ɛ 
Πικρό	p i k ɾ o 
Πλάγι	p l ɐ ɣ i 
Πλάκα	p l ɐ k ɐ 
Ποιος	p i o s 
Πρώτο	p ɾ o t̪ o 
Ρήγας	ɾ i ɣ ɐ s 
Ρίξου	ɾ i k s u 
Στάση	s t̪ ɐ s i 
Σωστό	s o s t̪ o 
Τούτο	t̪ u t̪ o 
Τόσοι	t̪ o s i 
Φέρτε	f ɛ ɾ t̪ ɛ 
Χωρίς	x o ɾ i s 
Ωραία	o ɾ ɛ ɐ 
άγρια	ɐ ɣ ɾ i ɐ 
άγριο	ɐ ɣ ɾ i o 
άδεια	ɐ ð i ɐ 
άδειο	ɐ ð i o 
άδικα	ɐ ð i k ɐ 
άδικη	ɐ ð i k i 
άκουε	ɐ k u ɛ 
άκρες	ɐ k ɾ ɛ s 
άλλες	ɐ l ɛ s 
άλλην	ɐ l i n̪ 
άλλης	ɐ l i s 
άλλοι	ɐ l i 
άλλον	ɐ l o n̪ 
άλλος	ɐ l o s 
άλλου	ɐ l u 
άλλων	ɐ l o n̪ 
άλογα	ɐ l o ɣ ɐ 
άλογο	ɐ l o ɣ o 
άναβε	ɐ n̪ ɐ v ɛ 
άναψε	ɐ n̪ ɐ p s ɛ 
άξιοι	ɐ k s i 
άξιος	ɐ k s i o s 
άραγε	ɐ ɾ ɐ ɣ ɛ 
άρεσε	ɐ ɾ ɛ s ɛ 
άσπρο	ɐ s p ɾ o 
άστρο	ɐ s t̪ ɾ o 
άτομο	ɐ t̪ o m o 
άφηνε	ɐ f i n̪ ɛ 
άφησε	ɐ f i s ɛ 
άχαρη	ɐ x ɐ ɾ i 
άχυρα	ɐ x i ɾ ɐ 
άχυρο	ɐ x i ɾ o 
άψητα	ɐ p s i t̪ ɐ 
έβαλε	ɛ v ɐ l ɛ 
έγινε	ɛ ɣ i n̪ ɛ 
έδεσε	ɛ ð ɛ s ɛ 
έδινε	ɛ ð i n̪ ɛ 
έδωσε	ɛ ð o s ɛ 
έζησα	ɛ z i s ɐ 
έθνος	ɛ θ n̪ o s 
έκαιε	ɛ k ɛ 
έκαμε	ɛ k ɐ m ɛ 
έκανα	ɛ k ɐ n̪ ɐ 
έκανε	ɛ k ɐ n̪ ɛ 
έκοψε	ɛ k o p s ɛ 
έλαβε	ɛ l ɐ v ɛ 
έλαχε	ɛ l ɐ x ɛ 
έλεγε	ɛ l ɛ ɣ ɛ 
έληξε	ɛ l i k s ɛ 
έλθει	ɛ l θ i 
έλυσε	ɛ l i s ɛ 
έμαθα	ɛ m ɐ θ ɐ 
έμαθε	ɛ m ɐ θ ɛ 
έμενε	ɛ m ɛ n̪ ɛ 
ένωνε	ɛ n̪ o n̪ ɛ 
έξαψη	ɛ k s ɐ p s i 
έξυσε	ɛ k s i s ɛ 
έπαθε	ɛ p ɐ θ ɛ 
έπεσε	ɛ p ɛ s ɛ 
έπινε	ɛ p i n̪ ɛ 
έραψε	ɛ ɾ ɐ p s ɛ 
έρθει	ɛ ɾ θ i 
έριξα	ɛ ɾ i k s ɐ 
έριξε	ɛ ɾ i k s ɛ 
έσυρε	ɛ s i ɾ ɛ 
έτυχε	ɛ t̪ i x ɛ 
έφαγα	ɛ f ɐ ɣ ɐ 
έφαγε	ɛ f ɐ ɣ ɛ 
έφερα	ɛ f ɛ ɾ ɐ 
έφερε	ɛ f ɛ ɾ ɛ 
έφυγε	ɛ f i ɣ ɛ 
έχανε	ɛ x ɐ n̪ ɛ 
έχασα	ɛ x ɐ s ɐ 
έχασε	ɛ x ɐ s ɛ 
έχεις	ɛ x i s 
έχομε	ɛ x o m ɛ 
έχουν	ɛ x u n̪ 
έχυσε	ɛ x i s ɛ 
έχωσε	ɛ x o s ɛ 
έψησε	ɛ p s i s ɛ 
ήθελα	i θ ɛ l ɐ 
ήθελε	i θ ɛ l ɛ 
ήλθαν	i l θ ɐ n̪ 
ήλθες	i l θ ɛ s 
ήλιος	i l i o s 
ήλιου	i l i u 
ήμουν	i m u n̪ 
ήξερα	i k s ɛ ɾ ɐ 
ήξερε	i k s ɛ ɾ ɛ 
ήπιαν	i p i ɐ n̪ 
ήρεμα	i ɾ ɛ m ɐ 
ήρθες	i ɾ θ ɛ s 
ήρωες	i ɾ o ɛ s 
ήσουν	i s u n̪ 
ήσυχα	i s i x ɐ 
ήσυχο	i s i x o 
ίδιας	i ð i ɐ s 
ίδιοι	i ð i 
ίδιος	i ð i o s 
αέρας	ɐ ɛ ɾ ɐ s 
αγάπη	ɐ ɣ ɐ p i 
αγορά	ɐ ɣ o ɾ ɐ 
αγόρι	ɐ ɣ o ɾ i 
αγώνα	ɐ ɣ o n̪ ɐ 
αηδία	ɐ i ð i ɐ 
αιτία	ɛ t̪ i ɐ 
ακούς	ɐ k u s 
ακόμα	ɐ k o m ɐ 
ακόμη	ɐ k o m i 
αμόνι	ɐ m o n̪ i 
αξίας	ɐ k s i ɐ s 
αξίνα	ɐ k s i n̪ ɐ 
αξιών	ɐ k s i o n̪ 
απάνω	ɐ p ɐ n̪ o 
απαλό	ɐ p ɐ l o 
απλός	ɐ p l o s 
απόψε	ɐ p o p s ɛ 
αργεί	ɐ ɾ ɣ i 
αρνιά	ɐ ɾ n̪ i ɐ 
αρχές	ɐ ɾ x ɛ s 
αυτές	ɐ f t̪ ɛ s 
αυτής	ɐ f t̪ i s 
αυτιά	ɐ f t̪ i ɐ 
αυτοί	ɐ f t̪ i 
αυτού	ɐ f t̪ u 
αυτόν	ɐ f t̪ o n̪ 
αυτός	ɐ f t̪ o s 
αφήνω	ɐ f i n̪ o 
αφορά	ɐ f o ɾ ɐ 
αύριο	ɐ v ɾ i o 
βάθος	v ɐ θ o s 
βάλτε	v ɐ l t̪ ɛ 
βάρκα	v ɐ ɾ k ɐ 
βάρος	v ɐ ɾ o s 
βάτος	v ɐ t̪ o s 
βέλος	v ɛ l o s 
βαθιά	v ɐ θ i ɐ 
βαριά	v ɐ ɾ i ɐ 
βαρύς	v ɐ ɾ i s 
βαστά	v ɐ s t̪ ɐ 
βγάλω	v ɣ ɐ l o 
βγήκα	v ɣ i k ɐ 
βγήκε	v ɣ i k ɛ 
βγουν	v ɣ u n̪ 
βλάκα	v l ɐ k ɐ 
βλέπω	v l ɛ p o 
βουβά	v u v ɐ 
βουνά	v u n̪ ɐ 
βουνό	v u n̪ o 
βράδυ	v ɾ ɐ ð i 
βράσω	v ɾ ɐ s o 
βράχο	v ɾ ɐ x o 
βρήκα	v ɾ i k ɐ 
βρήκε	v ɾ i k ɛ 
βρεις	v ɾ i s 
βρουν	v ɾ u n̪ 
βροχή	v ɾ o x i 
βόλτα	v o l t̪ ɐ 
γάμος	ɣ ɐ m o s 
γέλια	ɣ ɛ l i ɐ 
γέλιο	ɣ ɛ l i o 
γέρος	ɣ ɛ ɾ o s 
γίνει	ɣ i n̪ i 
γεύση	ɣ ɛ f s i 
γιατί	ɣ i ɐ t̪ i 
γκισέ	ɡ i s ɛ 
γλυκά	ɣ l i k ɐ 
γλύκα	ɣ l i k ɐ 
γνώμη	ɣ n̪ o m i 
γοργά	ɣ o ɾ ɣ ɐ 
γριάς	ɣ ɾ i ɐ s 
γρόθο	ɣ ɾ o θ o 
γυμνά	ɣ i m n̪ ɐ 
γυρνά	ɣ i ɾ n̪ ɐ 
γυρνώ	ɣ i ɾ n̪ o 
γωνία	ɣ o n̪ i ɐ 
γωνιά	ɣ o n̪ i ɐ 
δάκρυ	ð ɐ k ɾ i 
δάσος	ð ɐ s o s 
δέσει	ð ɛ s i 
δίκες	ð i k ɛ s 
δίκιο	ð i k i o 
δίνει	ð i n̪ i 
δίπλα	ð i p l ɐ 
δείξω	ð i k s o 
δείτε	ð i t̪ ɛ 
δειλά	ð i l ɐ 
δειλέ	ð i l ɛ 
δεξιά	ð ɛ k s i ɐ 
δικές	ð i k ɛ s 
δικοί	ð i k i 
δικός	ð i k o s 
διπλό	ð i p l o 
δούλο	ð u l o 
δούμε	ð u m ɛ 
δράνα	ð ɾ ɐ n̪ ɐ 
δρόμο	ð ɾ o m o 
δώσει	ð o s i 
είδαν	i ð ɐ n̪ 
είδες	i ð ɛ s 
είδος	i ð o s 
είμαι	i m ɛ 
είναι	i n̪ ɛ 
είπαν	i p ɐ n̪ 
είπες	i p ɛ s 
είσαι	i s ɛ 
είσθε	i s θ ɛ 
είστε	i s t̪ ɛ 
είχαν	i x ɐ n̪ 
είχες	i x ɛ s 
εαυτό	ɛ ɐ f t̪ o 
εδόθη	ɛ ð o θ i 
εκατό	ɛ k ɐ t̪ o 
εκτός	ɛ k t̪ o s 
ελάτε	ɛ l ɐ t̪ ɛ 
ελάφι	ɛ l ɐ f i 
ελιές	ɛ l i ɛ s 
εμένα	ɛ m ɛ n̪ ɐ 
εμείς	ɛ m i s 
εμεις	ɛ m i s 
ενόσω	ɛ n̪ o s o 
εορτή	ɛ o ɾ t̪ i 
επάνω	ɛ p ɐ n̪ o 
επαφή	ɛ p ɐ f i 
εσένα	ɛ s ɛ n̪ ɐ 
ευθύς	ɛ f θ i s 
εχθρό	ɛ x θ ɾ o 
ζάρια	z ɐ ɾ i ɐ 
ζέβρα	z ɛ v ɾ ɐ 
ζήσει	z i s i 
ζεστή	z ɛ s t̪ i 
ζητάς	z i t̪ ɐ s 
ζούμε	z u m ɛ 
ζούσε	z u s ɛ 
ζωηρά	z o i ɾ ɐ 
ζώνης	z o n̪ i s 
ηλίου	i l i u 
ημέρα	i m ɛ ɾ ɐ 
θέαμα	θ ɛ ɐ m ɐ 
θέλει	θ ɛ l i 
θέτει	θ ɛ t̪ i 
θαύμα	θ ɐ v m ɐ 
θείας	θ i ɐ s 
θείος	θ i o s 
θείου	θ i u 
θειού	θ i u 
θρέψω	θ ɾ ɛ p s o 
θρόνο	θ ɾ o n̪ o 
θυμός	θ i m o s 
θυσία	θ i s i ɐ 
ισχύς	i s x i s 
κάκου	k ɐ k u 
κάμπο	k ɐ b o 
κάνει	k ɐ n̪ i 
κάπου	k ɐ p u 
κάπως	k ɐ p o s 
κάρτα	k ɐ ɾ t̪ ɐ 
καίει	k ɛ i 
καβγά	k ɐ v ɣ ɐ 
καημό	k ɐ i m o 
καθώς	k ɐ θ o s 
καιρό	k ɛ ɾ o 
κακές	k ɐ k ɛ s 
κακία	k ɐ k i ɐ 
κακοί	k ɐ k i 
κακού	k ɐ k u 
κακός	k ɐ k o s 
καλές	k ɐ l ɛ s 
καλής	k ɐ l i s 
καλόν	k ɐ l o n̪ 
καλός	k ɐ l o s 
καμία	k ɐ m i ɐ 
καμιά	k ɐ m i ɐ 
καρπό	k ɐ ɾ p o 
καφές	k ɐ f ɛ s 
κείνα	k i n̪ ɐ 
κείνη	k i n̪ i 
κείνο	k i n̪ o 
κιόλα	k i o l ɐ 
κλαδί	k l ɐ ð i 
κλαις	k l ɛ s 
κοινό	k i n̪ o 
κομψό	k o m p s o 
κοντά	k o d̪ ɐ 
κορμί	k o ɾ m i 
κορμό	k o ɾ m o 
κουβά	k u v ɐ 
κουτή	k u t̪ i 
κουτί	k u t̪ i 
κούπα	k u p ɐ 
κρέας	k ɾ ɛ ɐ s 
κρίμα	k ɾ i m ɐ 
κρίνο	k ɾ i n̪ o 
κρίση	k ɾ i s i 
κρασί	k ɾ ɐ s i 
κτήμα	k t̪ i m ɐ 
κυπρί	k i p ɾ i 
κόμμα	k o m ɐ 
κόμπο	k o b o 
κόπος	k o p o s 
κόρες	k o ɾ ɛ s 
κόρης	k o ɾ i s 
κόρφο	k o ɾ f o 
κόσμο	k o s m o 
κότες	k o t̪ ɛ s 
κότσο	k o t̪ s o 
κόψει	k o p s i 
κύκλο	k i k l o 
κύριε	k i ɾ i ɛ 
λάθος	l ɐ θ o s 
λάμψη	l ɐ m p s i 
λέγει	l ɛ ɣ i 
λήξης	l i k s i s 
λίγες	l i ɣ ɛ s 
λίμνη	l i m n̪ i 
λίστα	l i s t̪ ɐ 
λαγοί	l ɐ ɣ i 
λαιμό	l ɛ m o 
λαούς	l ɐ u s 
λεπτά	l ɛ p t̪ ɐ 
λεπτό	l ɛ p t̪ o 
λευκή	l ɛ f k i 
λευκό	l ɛ f k o 
λεφτά	l ɛ f t̪ ɐ 
λεύκα	l ɛ f k ɐ 
λιγνό	l i ɣ n̪ o 
λογής	l o ɣ i s 
λοιπά	l i p ɐ 
λουρί	l u ɾ i 
λόγια	l o ɣ i ɐ 
λόγος	l o ɣ o s 
λόγου	l o ɣ u 
λόγχη	l o ɣ x i 
λύκος	l i k o s 
λύσσα	l i s ɐ 
μάθει	m ɐ θ i 
μάσκα	m ɐ s k ɐ 
μάτια	m ɐ t̪ i ɐ 
μάτσα	m ɐ t̪ s ɐ 
μάτσο	m ɐ t̪ s o 
μέλει	m ɛ l i 
μέρες	m ɛ ɾ ɛ s 
μέρος	m ɛ ɾ o s 
μήπως	m i p o s 
μίλια	m i l i ɐ 
μακρύ	m ɐ k ɾ i 
μαλλί	m ɐ l i 
ματιά	m ɐ t̪ i ɐ 
μαύρα	m ɐ v ɾ ɐ 
μαύρη	m ɐ v ɾ i 
μαύρο	m ɐ v ɾ o 
μείνω	m i n̪ o 
μεριά	m ɛ ɾ i ɐ 
μικρά	m i k ɾ ɐ 
μικρέ	m i k ɾ ɛ 
μικρή	m i k ɾ i 
μικρό	m i k ɾ o 
μιλάς	m i l ɐ s 
μιλάω	m i l ɐ o 
μισός	m i s o s 
μνήμη	m n̪ i m i 
μοίρα	m i ɾ ɐ 
μορφή	m o ɾ f i 
μούρη	m u ɾ i 
μπάλα	b ɐ l ɐ 
μπήκε	b i k ɛ 
μπορώ	b o ɾ o 
μπουν	b u n̪ 
μπρος	b ɾ o s 
μυαλά	m i ɐ l ɐ 
μυαλό	m i ɐ l o 
μόλις	m o l i s 
μόνος	m o n̪ o s 
μύτες	m i t̪ ɛ s 
νάνος	n̪ ɐ n̪ o s 
νέους	n̪ ɛ u s 
ναύτη	n̪ ɐ f t̪ i 
νερού	n̪ ɛ ɾ u 
νεύρα	n̪ ɛ v ɾ ɐ 
νιάτα	n̪ i ɐ t̪ ɐ 
νιώθω	n̪ i o θ o 
ντυθώ	d̪ i θ o 
νωρίς	n̪ o ɾ i s 
νόημα	n̪ o i m ɐ 
νύχτα	n̪ i x t̪ ɐ 
ξέρει	k s ɛ ɾ i 
ξανθή	k s ɐ n̪ θ i 
ξεχνά	k s ɛ x n̪ ɐ 
ξυπνά	k s i p n̪ ɐ 
ξύπνα	k s i p n̪ ɐ 
οθόνη	o θ o n̪ i 
οποία	o p i ɐ 
οποίο	o p i o 
ορούς	o ɾ u s 
πάγει	p ɐ ɣ i 
πάγκο	p ɐ ɡ o 
πάντα	p ɐ d̪ ɐ 
πάπια	p ɐ p i ɐ 
πάρει	p ɐ ɾ i 
πάρκο	p ɐ ɾ k o 
πάρτε	p ɐ ɾ t̪ ɛ 
πάρτι	p ɐ ɾ t̪ i 
πέντε	p ɛ d̪ ɛ 
πέσει	p ɛ s i 
πέτρα	p ɛ t̪ ɾ ɐ 
πήγαν	p i ɣ ɐ n̪ 
πήγες	p i ɣ ɛ s 
πήραν	p i ɾ ɐ n̪ 
πίκρα	p i k ɾ ɐ 
πίνει	p i n̪ i 
πίτες	p i t̪ ɛ s 
παιδί	p ɛ ð i 
παλιά	p ɐ l i ɐ 
παλιό	p ɐ l i o 
παρών	p ɐ ɾ o n̪ 
πείνα	p i n̪ ɐ 
πείσω	p i s o 
πείτε	p i t̪ ɛ 
πεδίο	p ɛ ð i o 
πεινώ	p i n̪ o 
περνά	p ɛ ɾ n̪ ɐ 
πεύκο	p ɛ f k o 
πιάνω	p i ɐ n̪ o 
πιάτα	p i ɐ t̪ ɐ 
πιάτο	p i ɐ t̪ o 
πικρά	p i k ɾ ɐ 
πικρή	p i k ɾ i 
πιουν	p i u n̪ 
πιούν	p i u n̪ 
πλάγι	p l ɐ ɣ i 
πλάκα	p l ɐ k ɐ 
πλάτη	p l ɐ t̪ i 
πλένω	p l ɛ n̪ o 
πλέον	p l ɛ o n̪ 
πλατύ	p l ɐ t̪ i 
πλώρη	p l o ɾ i 
ποδιά	p o ð i ɐ 
ποιον	p i o n̪ 
ποιος	p i o s 
πολλά	p o l ɐ 
πολλή	p o l i 
πονεί	p o n̪ i 
πουλά	p u l ɐ 
πουλί	p u l i 
πούμε	p u m ɛ 
πράμα	p ɾ ɐ m ɐ 
πράξη	p ɾ ɐ k s i 
πρίμα	p ɾ i m ɐ 
πρύμη	p ɾ i m i 
πρώτα	p ɾ o t̪ ɐ 
πρώτη	p ɾ o t̪ i 
πρώτο	p ɾ o t̪ o 
πτώμα	p t̪ o m ɐ 
πυκνά	p i k n̪ ɐ 
πόδια	p o ð i ɐ 
πόλης	p o l i s 
πόνος	p o n̪ o s 
πόρτα	p o ɾ t̪ ɐ 
πόσες	p o s ɛ s 
πύργο	p i ɾ ɣ o 
ράβει	ɾ ɐ v i 
ράστα	ɾ ɐ s t̪ ɐ 
ράψει	ɾ ɐ p s i 
ρίγος	ɾ i ɣ o s 
ρίζες	ɾ i z ɛ s 
ρίξει	ɾ i k s i 
ρίξου	ɾ i k s u 
ρίχνω	ɾ i x n̪ o 
ρεύμα	ɾ ɛ v m ɐ 
ριχθώ	ɾ i x θ o 
ρολόι	ɾ o l o i 
ρούχα	ɾ u x ɐ 
ρούχο	ɾ u x o 
ρυάκι	ɾ i ɐ k i 
ρωτάς	ɾ o t̪ ɐ s 
ρόδες	ɾ o ð ɛ s 
σάλες	s ɐ l ɛ s 
σέναν	s ɛ n̪ ɐ n̪ 
σαΐτα	s ɐ i t̪ ɐ 
σειρά	s i ɾ ɐ 
σιάξω	s i ɐ k s o 
σιωπή	s i o p i 
σκάβω	s k ɐ v o 
σκάκι	s k ɐ k i 
σκάλα	s k ɐ l ɐ 
σκάσω	s k ɐ s o 
σκέψη	s k ɛ p s i 
σκηνή	s k i n̪ i 
σκοπό	s k o p o 
σκόνη	s k o n̪ i 
σούζα	s u z ɐ 
σούπα	s u p ɐ 
σπίτι	s p i t̪ i 
σπαθί	s p ɐ θ i 
σπόρο	s p o ɾ o 
στάση	s t̪ ɐ s i 
στέγη	s t̪ ɛ ɣ i 
στήθη	s t̪ i θ i 
στενή	s t̪ ɛ n̪ i 
στενό	s t̪ ɛ n̪ o 
στους	s t̪ u s 
στόλο	s t̪ o l o 
στόμα	s t̪ o m ɐ 
στόχο	s t̪ o x o 
συχνά	s i x n̪ ɐ 
σφυρί	s f i ɾ i 
σχέση	s x ɛ s i 
σχήμα	s x i m ɐ 
σχίσω	s x i s o 
σωροί	s o ɾ i 
σωστά	s o s t̪ ɐ 
σωστό	s o s t̪ o 
σώσει	s o s i 
τάφος	t̪ ɐ f o s 
τέλος	t̪ ɛ l o s 
τέρας	t̪ ɛ ɾ ɐ s 
τέχνη	t̪ ɛ x n̪ i 
τίμια	t̪ i m i ɐ 
τίνος	t̪ i n̪ o s 
τζάκι	t̪ z ɐ k i 
τμήμα	t̪ m i m ɐ 
τοίχο	t̪ i x o 
τούτα	t̪ u t̪ ɐ 
τούτη	t̪ u t̪ i 
τούτο	t̪ u t̪ o 
τρέφω	t̪ ɾ ɛ f o 
τρέχω	t̪ ɾ ɛ x o 
τρίτο	t̪ ɾ i t̪ o 
τραβώ	t̪ ɾ ɐ v o 
τρανά	t̪ ɾ ɐ n̪ ɐ 
τρεις	t̪ ɾ i s 
τρελέ	t̪ ɾ ɛ l ɛ 
τρελό	t̪ ɾ ɛ l o 
τριών	t̪ ɾ i o n̪ 
τρόμο	t̪ ɾ o m o 
τρόπο	t̪ ɾ o p o 
τρύπα	t̪ ɾ i p ɐ 
τρώμε	t̪ ɾ o m ɛ 
τρώνε	t̪ ɾ o n̪ ɛ 
τσάπα	t̪ s ɐ p ɐ 
τσέπη	t̪ s ɛ p i 
τσίρο	t̪ s i ɾ o 
τόπος	t̪ o p o s 
τόπου	t̪ o p u 
τόρνο	t̪ o ɾ n̪ o 
τόσες	t̪ o s ɛ s 
τόσην	t̪ o s i n̪ 
τόσοι	t̪ o s i 
τόσον	t̪ o s o n̪ 
τόσος	t̪ o s o s 
τύπος	t̪ i p o s 
τύχει	t̪ i x i 
υγεία	i ɣ i ɐ 
φάγει	f ɐ ɣ i 
φάρας	f ɐ ɾ ɐ s 
φέξει	f ɛ k s i 
φέρει	f ɛ ɾ i 
φέρνω	f ɛ ɾ n̪ o 
φίλου	f i l u 
φαγιά	f ɐ ɣ i ɐ 
φανεί	f ɐ n̪ i 
φαρδύ	f ɐ ɾ ð i 
φερθώ	f ɛ ɾ θ o 
φεύγω	f ɛ v ɣ o 
φθάσω	f θ ɐ s o 
φθόνο	f θ o n̪ o 
φλόγα	f l o ɣ ɐ 
φορέα	f o ɾ ɛ ɐ 
φορές	f o ɾ ɛ s 
φορεί	f o ɾ i 
φράση	f ɾ ɐ s i 
φρίκη	f ɾ i k i 
φρύδι	f ɾ i ð i 
φταις	f t̪ ɛ s 
φτερά	f t̪ ɛ ɾ ɐ 
φτωχό	f t̪ o x o 
φωλιά	f o l i ɐ 
φωνές	f o n̪ ɛ s 
φωτιά	f o t̪ i ɐ 
φόβος	f o v o s 
φόνοι	f o n̪ i 
φύγει	f i ɣ i 
φύλλα	f i l ɐ 
φύλλο	f i l o 
χάλια	x ɐ l i ɐ 
χάνει	x ɐ n̪ i 
χάσει	x ɐ s i 
χέρια	x ɛ ɾ i ɐ 
χήνες	x i n̪ ɛ s 
χαθεί	x ɐ θ i 
χαρές	x ɐ ɾ ɛ s 
χαρτί	x ɐ ɾ t̪ i 
χλωμό	x l o m o 
χρέος	x ɾ ɛ o s 
χρήση	x ɾ i s i 
χρυσά	x ɾ i s ɐ 
χρυσή	x ɾ i s i 
χρυσό	x ɾ i s o 
χρόνο	x ɾ o n̪ o 
χρώμα	x ɾ o m ɐ 
χτένι	x t̪ ɛ n̪ i 
χτίσω	x t̪ i s o 
χωρίς	x o ɾ i s 
χωρεί	x o ɾ i 
χωριά	x o ɾ i ɐ 
χωριό	x o ɾ i o 
χόρτα	x o ɾ t̪ ɐ 
χώρας	x o ɾ ɐ s 
χώρες	x o ɾ ɛ s 
ψήνει	p s i n̪ i 
ψεύτη	p s ɛ f t̪ i 
ψηθεί	p s i θ i 
ψηλής	p s i l i s 
ψηλός	p s i l o s 
ψηφία	p s i f i ɐ 
ψυχής	p s i x i s 
ωμέγα	o m ɛ ɣ ɐ 
ωραία	o ɾ ɛ ɐ 
ωραίε	o ɾ ɛ 
ωραίο	o ɾ ɛ o 
όλους	o l u s 
όνομά	o n̪ o m ɐ 
όνομα	o n̪ o m ɐ 
όντως	o d̪ o s 
όποιο	o p i o 
όποτε	o p o t̪ ɛ 
όρεξη	o ɾ ɛ k s i 
όρθια	o ɾ θ i ɐ 
όρθιο	o ɾ θ i o 
όρνια	o ɾ n̪ i ɐ 
όχημα	o x i m ɐ 
όχθες	o x θ ɛ s 
όχθης	o x θ i s 
ύπνος	i p n̪ o s 
ύπνου	i p n̪ u 
ώμους	o m u s 
ώριμη	o ɾ i m i 
ώσπου	o s p u 
‘μεις	m i s 
πέντε-έξι	p ɛ d̪ ɛ k s i 
απάνω-κάτω	ɐ p ɐ n̪ o k ɐ t̪ o 
αγάλι-αγάλι	ɐ ɣ ɐ l i ɐ ɣ ɐ l i 
μικρό-μικρό	m i k ɾ o m i k ɾ o 
πλάγι-πλάγι	p l ɐ ɣ i p l ɐ ɣ i 
πρώτα-πρώτα	p ɾ o t̪ ɐ p ɾ o t̪ ɐ 
Άκουσε	ɐ k u s ɛ 
Άμπλας	ɐ b l ɐ s 
Άνοιξε	ɐ n̪ i k s ɛ 
Άπλωνε	ɐ p l o n̪ ɛ 
Άπλωσε	ɐ p l o s ɛ 
Άρματα	ɐ ɾ m ɐ t̪ ɐ 
Άρπαξε	ɐ ɾ p ɐ k s ɛ 
Άρχισε	ɐ ɾ x i s ɛ 
Άσχημα	ɐ s x i m ɐ 
Έβγαλε	ɛ v ɣ ɐ l ɛ 
Έβρισε	ɛ v ɾ i s ɛ 
Έθαψαν	ɛ θ ɐ p s ɐ n̪ 
Έκλεψε	ɛ k l ɛ p s ɛ 
Έκοβαν	ɛ k o v ɐ n̪ 
Έλειπε	ɛ l i p ɛ 
Έμαθες	ɛ m ɐ θ ɛ s 
Έμεινε	ɛ m i n̪ ɛ 
Ένιωσε	ɛ n̪ i o s ɛ 
Έννοια	ɛ n̪ n̪ i ɐ 
Έξαφνα	ɛ k s ɐ f n̪ ɐ 
Έπειτα	ɛ p i t̪ ɐ 
Έπρεπε	ɛ p ɾ ɛ p ɛ 
Έσκυψε	ɛ s k i p s ɛ 
Έτρεξε	ɛ t̪ ɾ ɛ k s ɛ 
Έφαγες	ɛ f ɐ ɣ ɛ s 
Έφθασε	ɛ f θ ɐ s ɛ 
Έχουμε	ɛ x u m ɛ 
Ύστερα	i s t̪ ɛ ɾ ɐ 
Αγκαλά	ɐ ɡ ɐ l ɐ 
Αδελφή	ɐ ð ɛ l f i 
Αλλιώς	ɐ l i o s 
Αμέσως	ɐ m ɛ s o s 
Αμοργό	ɐ m o ɾ ɣ o 
Αντάρα	ɐ d̪ ɐ ɾ ɐ 
Αξίζει	ɐ k s i z i 
Αφέντη	ɐ f ɛ d̪ i 
Βέβαια	v ɛ v ɛ ɐ 
Βγάλτε	v ɣ ɐ l t̪ ɛ 
Βγήκαν	v ɣ i k ɐ n̪ 
Γέφυρα	ɣ ɛ f i ɾ ɐ 
Γενικά	ɣ ɛ n̪ i k ɐ 
Γενικό	ɣ ɛ n̪ i k o 
Γιώργο	ɣ i o ɾ ɣ o 
Γνώσης	ɣ n̪ o s i s 
Γύρευε	ɣ i ɾ ɛ v ɛ 
Γύριζα	ɣ i ɾ i z ɐ 
Γύρισε	ɣ i ɾ i s ɛ 
Δάκρυα	ð ɐ k ɾ i ɐ 
Δηλαδή	ð i l ɐ ð i 
Δούλος	ð u l o s 
Δρόμος	ð ɾ o m o s 
Ειδεμή	i ð ɛ m i 
Εκείνη	ɛ k i n̪ i 
Εκείνο	ɛ k i n̪ o 
Εμπρός	ɛ b ɾ o s 
Επίσης	ɛ p i s i s 
Ετούτη	ɛ t̪ u t̪ i 
Ζήλιως	z i l i o s 
Ζήτησε	z i t̪ i s ɛ 
Ζητάμε	z i t̪ ɐ m ɛ 
Ησυχία	i s i x i ɐ 
Θάρρος	θ ɐ ɾ o s 
Θέλεις	θ ɛ l i s 
Θέλησε	θ ɛ l i s ɛ 
Κάθισε	k ɐ θ i s ɛ 
Κάνεις	k ɐ n̪ i s 
Κάνετε	k ɐ n̪ ɛ t̪ ɛ 
Κάστρα	k ɐ s t̪ ɾ ɐ 
Κάστρο	k ɐ s t̪ ɾ o 
Καιρός	k ɛ ɾ o s 
Κανένα	k ɐ n̪ ɛ n̪ ɐ 
Κανείς	k ɐ n̪ i s 
Κλείσε	k l i s ɛ 
Κουτός	k u t̪ o s 
Κούκλα	k u k l ɐ 
Κούκος	k u k o s 
Κράτος	k ɾ ɐ t̪ o s 
Κυνηγώ	k i n̪ i ɣ o 
Λοιπόν	l i p o n̪ 
Μάζεψα	m ɐ z ɛ p s ɐ 
Μάζεψε	m ɐ z ɛ p s ɛ 
Μάλλον	m ɐ l o n̪ 
Μήτσος	m i t̪ s o s 
Μίλησε	m i l i s ɛ 
Μακριά	m ɐ k ɾ i ɐ 
Μερικά	m ɛ ɾ i k ɐ 
Μητέρα	m i t̪ ɛ ɾ ɐ 
Μονάχα	m o n̪ ɐ x ɐ 
Μοναχή	m o n̪ ɐ x i 
Μπήκαν	b i k ɐ n̪ 
Μπορεί	b o ɾ i 
Μπράβο	b ɾ ɐ v o 
Νομίζω	n̪ o m i z o 
Ντροπή	d̪ ɾ o p i 
Ξάφνου	k s ɐ f n̪ u 
Ξέρεις	k s ɛ ɾ i s 
Ξέχασε	k s ɛ x ɐ s ɛ 
Οπόταν	o p o t̪ ɐ n̪ 
Ορίστε	o ɾ i s t̪ ɛ 
Πάντως	p ɐ d̪ o s 
Πάπιες	p ɐ p i ɛ s 
Πάτησε	p ɐ t̪ i s ɛ 
Πέθανε	p ɛ θ ɐ n̪ ɛ 
Πέρασε	p ɛ ɾ ɐ s ɛ 
Πήδηξε	p i ð i k s ɛ 
Παίρνω	p ɛ ɾ n̪ o 
Παλάβω	p ɐ l ɐ v o 
Παντού	p ɐ d̪ u 
Πατέρα	p ɐ t̪ ɛ ɾ ɐ 
Πελέκα	p ɛ l ɛ k ɐ 
Πλήθος	p l i θ o s 
Πολλές	p o l ɛ s 
Πουλιά	p u l i ɐ 
Πρέπει	p ɾ ɛ p i 
Ρωτάει	ɾ o t̪ ɐ i 
Ρώτησε	ɾ o t̪ i s ɛ 
Σέρβος	s ɛ ɾ v o s 
Σήμανε	s i m ɐ n̪ ɛ 
Σήμερα	s i m ɛ ɾ ɐ 
Σκοποί	s k o p i 
Σκοπός	s k o p o s 
Σκύβει	s k i v i 
Σπρώξε	s p ɾ o k s ɛ 
Στάσου	s t̪ ɐ s u 
Στείλε	s t̪ i l ɛ 
Στόλος	s t̪ o l o s 
Σχεδόν	s x ɛ ð o n̪ 
Σύναξε	s i n̪ ɐ k s ɛ 
Τέτοια	t̪ ɛ t̪ i ɐ 
Τίποτα	t̪ i p o t̪ ɐ 
Τίποτε	t̪ i p o t̪ ɛ 
Τελικά	t̪ ɛ l i k ɐ 
Τζοτζέ	t̪ z o t̪ z ɛ 
Φανάρι	f ɐ n̪ ɐ ɾ i 
Φθάνει	f θ ɐ n̪ i 
Φοβέρα	f o v ɛ ɾ ɐ 
Φτιάσε	f t̪ i ɐ s ɛ 
Φόρεσε	f o ɾ ɛ s ɛ 
Φύγαμε	f i ɣ ɐ m ɛ 
Φύλαξα	f i l ɐ k s ɐ 
Φώναξα	f o n̪ ɐ k s ɐ 
Φώναξε	f o n̪ ɐ k s ɛ 
Χάνομε	x ɐ n̪ o m ɛ 
Χάρηκε	x ɐ ɾ i k ɛ 
Χλωμός	x l o m o s 
Χτίζει	x t̪ i z i 
Ψέματα	p s ɛ m ɐ t̪ ɐ 
Ωστόσο	o s t̪ o s o 
άγριες	ɐ ɣ ɾ i ɛ s 
άδικος	ɐ ð i k o s 
άεργες	ɐ ɛ ɾ ɣ ɛ s 
άκουσα	ɐ k u s ɐ 
άκουσε	ɐ k u s ɛ 
άλέιψε	ɐ l ɛ i p s ɛ 
άλλαξε	ɐ l ɐ k s ɛ 
άλλοτε	ɐ l o t̪ ɛ 
άλλους	ɐ l u s 
άναψαν	ɐ n̪ ɐ p s ɐ n̪ 
άνοιγε	ɐ n̪ i ɣ ɛ 
άνοιξε	ɐ n̪ i k s ɛ 
άντρες	ɐ d̪ ɾ ɛ s 
άπλωνε	ɐ p l o n̪ ɛ 
άπλωσε	ɐ p l o s ɛ 
άραξαν	ɐ ɾ ɐ k s ɐ n̪ 
άρεσαν	ɐ ɾ ɛ s ɐ n̪ 
άρματα	ɐ ɾ m ɐ t̪ ɐ 
άρμεγε	ɐ ɾ m ɛ ɣ ɛ 
άρπαξα	ɐ ɾ p ɐ k s ɐ 
άρπαξε	ɐ ɾ p ɐ k s ɛ 
άρχιζε	ɐ ɾ x i z ɛ 
άρχισε	ɐ ɾ x i s ɛ 
άσκοπα	ɐ s k o p ɐ 
άσχημα	ɐ s x i m ɐ 
άτακτα	ɐ t̪ ɐ k t̪ ɐ 
άφωνος	ɐ f o n̪ o s 
έβαλαν	ɛ v ɐ l ɐ n̪ 
έβγαζα	ɛ v ɣ ɐ z ɐ 
έβγαζε	ɛ v ɣ ɐ z ɛ 
έβγαλε	ɛ v ɣ ɐ l ɛ 
έβλαψε	ɛ v l ɐ p s ɛ 
έβλεπα	ɛ v l ɛ p ɐ 
έβλεπε	ɛ v l ɛ p ɛ 
έβρασα	ɛ v ɾ ɐ s ɐ 
έβρισε	ɛ v ɾ i s ɛ 
έγειρε	ɛ ɣ i ɾ ɛ 
έγνεφε	ɛ ɣ n̪ ɛ f ɛ 
έγνεψε	ɛ ɣ n̪ ɛ p s ɛ 
έγραφε	ɛ ɣ ɾ ɐ f ɛ 
έγραψε	ɛ ɣ ɾ ɐ p s ɛ 
έδειξε	ɛ ð i k s ɛ 
έδεναν	ɛ ð ɛ n̪ ɐ n̪ 
έδεσαν	ɛ ð ɛ s ɐ n̪ 
έδιωξε	ɛ ð i o k s ɛ 
έδωσαν	ɛ ð o s ɐ n̪ 
έδωσες	ɛ ð o s ɛ s 
έκαναν	ɛ k ɐ n̪ ɐ n̪ 
έκανες	ɛ k ɐ n̪ ɛ s 
έκλαψε	ɛ k l ɐ p s ɛ 
έκλεβε	ɛ k l ɛ v ɛ 
έκλεψα	ɛ k l ɛ p s ɐ 
έκλεψε	ɛ k l ɛ p s ɛ 
έκρυψε	ɛ k ɾ i p s ɛ 
έκταση	ɛ k t̪ ɐ s i 
έλαμπε	ɛ l ɐ b ɛ 
έλαμψε	ɛ l ɐ m p s ɛ 
έλεγαν	ɛ l ɛ ɣ ɐ n̪ 
έλεγες	ɛ l ɛ ɣ ɛ s 
έλεγχο	ɛ l ɛ ɣ x o 
έλθεις	ɛ l θ i s 
έλθομε	ɛ l θ o m ɛ 
έλθουν	ɛ l θ u n̪ 
έμαθες	ɛ m ɐ θ ɛ s 
έμεινα	ɛ m i n̪ ɐ 
έμεινε	ɛ m i n̪ ɛ 
έμεναν	ɛ m ɛ n̪ ɐ n̪ 
έμπηξε	ɛ b i k s ɛ 
ένιωθε	ɛ n̪ i o θ ɛ 
ένιωσε	ɛ n̪ i o s ɛ 
έννοια	ɛ n̪ n̪ i ɐ 
έντομα	ɛ d̪ o m ɐ 
έντομο	ɛ d̪ o m o 
ένωναν	ɛ n̪ o n̪ ɐ n̪ 
έξαφνα	ɛ k s ɐ f n̪ ɐ 
έπαθες	ɛ p ɐ θ ɛ s 
έπαιζε	ɛ p ɛ z ɛ 
έπαυσε	ɛ p ɐ f s ɛ 
έπεσαν	ɛ p ɛ s ɐ n̪ 
έπεσες	ɛ p ɛ s ɛ s 
έπεφτε	ɛ p ɛ f t̪ ɛ 
έπιασα	ɛ p i ɐ s ɐ 
έπιασε	ɛ p i ɐ s ɛ 
έπιναν	ɛ p i n̪ ɐ n̪ 
έπιπλα	ɛ p i p l ɐ 
έπιπλο	ɛ p i p l o 
έπρεπε	ɛ p ɾ ɛ p ɛ 
έρημης	ɛ ɾ i m i s 
έρθεις	ɛ ɾ θ i s 
έριχνε	ɛ ɾ i x n̪ ɛ 
έσβησε	ɛ s v i s ɛ 
έσερνε	ɛ s ɛ ɾ n̪ ɛ 
έσκαβα	ɛ s k ɐ v ɐ 
έσκασε	ɛ s k ɐ s ɛ 
έσκυψε	ɛ s k i p s ɛ 
έσπασε	ɛ s p ɐ s ɛ 
έστεκε	ɛ s t̪ ɛ k ɛ 
έσυραν	ɛ s i ɾ ɐ n̪ 
έσφιξε	ɛ s f i k s ɛ 
έσχισε	ɛ s x i s ɛ 
έτοιμα	ɛ t̪ i m ɐ 
έτοιμο	ɛ t̪ i m o 
έτρεμε	ɛ t̪ ɾ ɛ m ɛ 
έτρεξε	ɛ t̪ ɾ ɛ k s ɛ 
έτρεχε	ɛ t̪ ɾ ɛ x ɛ 
έτρεψε	ɛ t̪ ɾ ɛ p s ɛ 
έτριψε	ɛ t̪ ɾ i p s ɛ 
έτρωγε	ɛ t̪ ɾ o ɣ ɛ 
έφαγαν	ɛ f ɐ ɣ ɐ n̪ 
έφαγες	ɛ f ɐ ɣ ɛ s 
έφεραν	ɛ f ɛ ɾ ɐ n̪ 
έφερες	ɛ f ɛ ɾ ɛ s 
έφερνε	ɛ f ɛ ɾ n̪ ɛ 
έφευγε	ɛ f ɛ v ɣ ɛ 
έφθανα	ɛ f θ ɐ n̪ ɐ 
έφθανε	ɛ f θ ɐ n̪ ɛ 
έφθασε	ɛ f θ ɐ s ɛ 
έφτασε	ɛ f t̪ ɐ s ɛ 
έφυγαν	ɛ f i ɣ ɐ n̪ 
έχασκε	ɛ x ɐ s k ɛ 
έχουμε	ɛ x u m ɛ 
έχτιζε	ɛ x t̪ i z ɛ 
ήθελες	i θ ɛ l ɛ s 
ήλθαμε	i l θ ɐ m ɛ 
ήξεραν	i k s ɛ ɾ ɐ n̪ 
ήξερες	i k s ɛ ɾ ɛ s 
ήρθαμε	i ɾ θ ɐ m ɛ 
ήσυχος	i s i x o s 
ίσιασε	i s i ɐ s ɛ 
ίσιωσε	i s i o s ɛ 
αγαπάω	ɐ ɣ ɐ p ɐ o 
αγωνία	ɐ ɣ o n̪ i ɐ 
αγόρια	ɐ ɣ o ɾ i ɐ 
αδελφέ	ɐ ð ɛ l f ɛ 
αδελφή	ɐ ð ɛ l f i 
αδελφό	ɐ ð ɛ l f o 
αεράκι	ɐ ɛ ɾ ɐ k i 
αιώνια	ɛ o n̪ i ɐ 
ακούει	ɐ k u i 
ακούσω	ɐ k u s o 
ακούτε	ɐ k u t̪ ɛ 
ακριβά	ɐ k ɾ i v ɐ 
ακριβό	ɐ k ɾ i v o 
αλλιώς	ɐ l i o s 
αλόγου	ɐ l o ɣ u 
αμάξια	ɐ m ɐ k s i ɐ 
αμέσως	ɐ m ɛ s o s 
ανάγκη	ɐ n̪ ɐ ɡ i 
ανάψει	ɐ n̪ ɐ p s i 
ανέβει	ɐ n̪ ɛ v i 
ανεψιέ	ɐ n̪ ɛ p s i ɛ 
ανηψιέ	ɐ n̪ i p s i ɛ 
ανοίξω	ɐ n̪ i k s o 
αντάρα	ɐ d̪ ɐ ɾ ɐ 
ανόητη	ɐ n̪ o i t̪ i 
αξίζει	ɐ k s i z i 
αξίνες	ɐ k s i n̪ ɛ s 
απορία	ɐ p o ɾ i ɐ 
απόντα	ɐ p o d̪ ɐ 
αργήσω	ɐ ɾ ɣ i s o 
αριθμό	ɐ ɾ i θ m o 
αρκετά	ɐ ɾ k ɛ t̪ ɐ 
αρκετή	ɐ ɾ k ɛ t̪ i 
αρχηγό	ɐ ɾ x i ɣ o 
αρχικό	ɐ ɾ x i k o 
ασθενή	ɐ s θ ɛ n̪ i 
αστεία	ɐ s t̪ i ɐ 
αστείο	ɐ s t̪ i o 
αστικά	ɐ s t̪ i k ɐ 
αταξία	ɐ t̪ ɐ k s i ɐ 
ατυχία	ɐ t̪ i x i ɐ 
αυθάδη	ɐ f θ ɐ ð i 
αυτούς	ɐ f t̪ u s 
αφέντη	ɐ f ɛ d̪ i 
αφήνει	ɐ f i n̪ i 
αφήσει	ɐ f i s i 
αφότου	ɐ f o t̪ u 
βάζεις	v ɐ z i s 
βάλανε	v ɐ l ɐ n̪ ɛ 
βάλουν	v ɐ l u n̪ 
βάρκες	v ɐ ɾ k ɛ s 
βάσανα	v ɐ s ɐ n̪ ɐ 
βέβαια	v ɛ v ɛ ɐ 
βήματα	v i m ɐ t̪ ɐ 
βγάζει	v ɣ ɐ z i 
βγάλει	v ɣ ɐ l i 
βγήκαν	v ɣ i k ɐ n̪ 
βγούμε	v ɣ u m ɛ 
βελόνα	v ɛ l o n̪ ɐ 
βιβλία	v i v l i ɐ 
βιβλίο	v i v l i o 
βλάκας	v l ɐ k ɐ s 
βλέμμα	v l ɛ m ɐ 
βλέπει	v l ɛ p i 
βουνού	v u n̪ u 
βούρλο	v u ɾ l o 
βράζει	v ɾ ɐ z i 
βράχοι	v ɾ ɐ x i 
βρέξει	v ɾ ɛ k s i 
βρήκαν	v ɾ i k ɐ n̪ 
βρήκες	v ɾ i k ɛ s 
βρίζει	v ɾ i z i 
βρίσει	v ɾ i s i 
βραστό	v ɾ ɐ s t̪ o 
βραχνή	v ɾ ɐ x n̪ i 
βρεθεί	v ɾ ɛ θ i 
βρούμε	v ɾ u m ɛ 
γέλασε	ɣ ɛ l ɐ s ɛ 
γέμιζε	ɣ ɛ m i z ɛ 
γέμισα	ɣ ɛ m i s ɐ 
γέμισε	ɣ ɛ m i s ɛ 
γέρους	ɣ ɛ ɾ u s 
γέφυρα	ɣ ɛ f i ɾ ɐ 
γίνεις	ɣ i n̪ i s 
γίνηκε	ɣ i n̪ i k ɛ 
γίνουν	ɣ i n̪ u n̪ 
γαβάθα	ɣ ɐ v ɐ θ ɐ 
γαμπρό	ɣ ɐ b ɾ o 
γείρει	ɣ i ɾ i 
γεμάτα	ɣ ɛ m ɐ t̪ ɐ 
γεμάτο	ɣ ɛ m ɐ t̪ o 
γενικά	ɣ ɛ n̪ i k ɐ 
γενική	ɣ ɛ n̪ i k i 
γενικό	ɣ ɛ n̪ i k o 
γιάνει	ɣ i ɐ n̪ i 
γιατρό	ɣ i ɐ t̪ ɾ o 
γιαχνί	ɣ i ɐ x n̪ i 
γιόκας	ɣ i o k ɐ s 
γκρεμό	ɡ ɾ ɛ m o 
γλυκιά	ɣ l i k i ɐ 
γλώσσα	ɣ l o s ɐ 
γούστα	ɣ u s t̪ ɐ 
γράμμα	ɣ ɾ ɐ m ɐ 
γράφει	ɣ ɾ ɐ f i 
γράψει	ɣ ɾ ɐ p s i 
γραμμή	ɣ ɾ ɐ m i 
γυαλιά	ɣ i ɐ l i ɐ 
γυμνές	ɣ i m n̪ ɛ s 
γυρίσω	ɣ i ɾ i s o 
γυρεύω	ɣ i ɾ ɛ v o 
γυρνάς	ɣ i ɾ n̪ ɐ s 
γωνιάς	ɣ o n̪ i ɐ s 
γωνιές	ɣ o n̪ i ɛ s 
γόνατά	ɣ o n̪ ɐ t̪ ɐ 
γόνατα	ɣ o n̪ ɐ t̪ ɐ 
γύρευα	ɣ i ɾ ɛ v ɐ 
γύρευε	ɣ i ɾ ɛ v ɛ 
γύριζα	ɣ i ɾ i z ɐ 
γύριζε	ɣ i ɾ i z ɛ 
γύρισα	ɣ i ɾ i s ɐ 
γύρισε	ɣ i ɾ i s ɛ 
γύρους	ɣ i ɾ u s 
δάκρυα	ð ɐ k ɾ i ɐ 
δάσους	ð ɐ s u s 
δάφνης	ð ɐ f n̪ i s 
δέθηκε	ð ɛ θ i k ɛ 
δέντρα	ð ɛ d̪ ɾ ɐ 
δέντρο	ð ɛ d̪ ɾ o 
δέσατε	ð ɛ s ɐ t̪ ɛ 
δίκαιο	ð i k ɛ o 
δίνεις	ð i n̪ i s 
δαπάνη	ð ɐ p ɐ n̪ i 
δείξει	ð i k s i 
δείπνο	ð i p n̪ o 
δειλοί	ð i l i 
δεκάξι	ð ɛ k ɐ k s i 
δεμένα	ð ɛ m ɛ n̪ ɐ 
δεμένο	ð ɛ m ɛ n̪ o 
δηλαδή	ð i l ɐ ð i 
δικούς	ð i k u s 
διώξει	ð i o k s i 
δροσιά	ð ɾ o s i ɐ 
δρόμοι	ð ɾ o m i 
δρόμος	ð ɾ o m o s 
δρόμου	ð ɾ o m u 
δυνατά	ð i n̪ ɐ t̪ ɐ 
δυνατό	ð i n̪ ɐ t̪ o 
δυτική	ð i t̪ i k i 
δωρητή	ð o ɾ i t̪ i 
δόλιον	ð o l i o n̪ 
δόντια	ð o d̪ i ɐ 
δύναμη	ð i n̪ ɐ m i 
δώδεκα	ð o ð ɛ k ɐ 
δώσεις	ð o s i s 
δώσετε	ð o s ɛ t̪ ɛ 
είδαμε	i ð ɐ m ɛ 
είδηση	i ð i s i 
είκοσι	i k o s i 
είσοδο	i s o ð o 
ειδεμή	i ð ɛ m i 
ειδική	i ð i k i 
εκατόν	ɛ k ɐ t̪ o n̪ 
εκείνα	ɛ k i n̪ ɐ 
εκείνη	ɛ k i n̪ i 
εκείνο	ɛ k i n̪ o 
ελάφια	ɛ l ɐ f i ɐ 
ελπίδα	ɛ l p i ð ɐ 
ελπίζω	ɛ l p i z o 
εμπρός	ɛ b ɾ o s 
εξάψει	ɛ k s ɐ p s i 
εξηγεί	ɛ k s i ɣ i 
εξοχής	ɛ k s o x i s 
εξόδου	ɛ k s o ð u 
επειδή	ɛ p i ð i 
εποχής	ɛ p o x i s 
εποχών	ɛ p o x o n̪ 
ερημιά	ɛ ɾ i m i ɐ 
ετούτο	ɛ t̪ u t̪ o 
ευθύνη	ɛ f θ i n̪ i 
ευπαθή	ɛ f p ɐ θ i 
ευωδιά	ɛ v o ð i ɐ 
εχθροί	ɛ x θ ɾ i 
εχθρού	ɛ x θ ɾ u 
εχθρός	ɛ x θ ɾ o s 
εύκολα	ɛ f k o l ɐ 
εύκολο	ɛ f k o l o 
ζήσεις	z i s i s 
ζήτησα	z i t̪ i s ɐ 
ζήτησε	z i t̪ i s ɛ 
ζακέτα	z ɐ k ɛ t̪ ɐ 
ζεστοί	z ɛ s t̪ i 
ζεστός	z ɛ s t̪ o s 
ζητάτε	z i t̪ ɐ t̪ ɛ 
ζητήσω	z i t̪ i s o 
ζούσαν	z u s ɐ n̪ 
ζυμώνω	z i m o n̪ o 
ζωύφιο	z o i f i o 
ζύγωσε	z i ɣ o s ɛ 
ζώντας	z o d̪ ɐ s 
ηλίθια	i l i θ i ɐ 
ηλικία	i l i k i ɐ 
ημέρας	i m ɛ ɾ ɐ s 
ηρωικά	i ɾ o i k ɐ 
ηρωική	i ɾ o i k i 
ησυχία	i s i x i ɐ 
θάλαμο	θ ɐ l ɐ m o 
θάρρος	θ ɐ ɾ o s 
θέλαμε	θ ɛ l ɐ m ɛ 
θέλατε	θ ɛ l ɐ t̪ ɛ 
θέλεις	θ ɛ l i s 
θέλετε	θ ɛ l ɛ t̪ ɛ 
θέλησα	θ ɛ l i s ɐ 
θέλησε	θ ɛ l i s ɛ 
θέληση	θ ɛ l i s i 
θέλομε	θ ɛ l o m ɛ 
θέλουν	θ ɛ l u n̪ 
θέματα	θ ɛ m ɐ t̪ ɐ 
θέριζε	θ ɛ ɾ i z ɛ 
θελήσω	θ ɛ l i s o 
θρέψει	θ ɾ ɛ p s i 
θυμώσω	θ i m o s o 
θυσίες	θ i s i ɛ s 
θόλωσε	θ o l o s ɛ 
θόρυβο	θ o ɾ i v o 
θύμισέ	θ i m i s ɛ 
θύμωνε	θ i m o n̪ ɛ 
θύμωσε	θ i m o s ɛ 
ιδρώτα	i ð ɾ o t̪ ɐ 
ιππικό	i p i k o 
ισχύει	i s x i 
κάθησε	k ɐ θ i s ɛ 
κάθισε	k ɐ θ i s ɛ 
κάλλιο	k ɐ l i o 
κάμαρά	k ɐ m ɐ ɾ ɐ 
κάμαρα	k ɐ m ɐ ɾ ɐ 
κάμπου	k ɐ b u 
κάναμε	k ɐ n̪ ɐ m ɛ 
κάνατε	k ɐ n̪ ɐ t̪ ɛ 
κάνεις	k ɐ n̪ i s 
κάνετε	k ɐ n̪ ɛ t̪ ɛ 
κάνομε	k ɐ n̪ o m ɛ 
κάνουν	k ɐ n̪ u n̪ 
κάποια	k ɐ p i ɐ 
κάποιο	k ɐ p i o 
κάποτε	k ɐ p o t̪ ɛ 
κάρτες	k ɐ ɾ t̪ ɛ s 
κάστρα	k ɐ s t̪ ɾ ɐ 
κέντρο	k ɛ d̪ ɾ o 
κέρδος	k ɛ ɾ ð o s 
κίνησε	k i n̪ i s ɛ 
κίνηση	k i n̪ i s i 
καβγάς	k ɐ v ɣ ɐ s 
καζάνι	k ɐ z ɐ n̪ i 
καθένα	k ɐ θ ɛ n̪ ɐ 
καθησε	k ɐ θ i s ɛ 
καιροί	k ɛ ɾ i 
καιρός	k ɛ ɾ o s 
καιρών	k ɛ ɾ o n̪ 
κακούς	k ɐ k u s 
καλάθι	k ɐ l ɐ θ i 
καλούς	k ɐ l u s 
καλύβα	k ɐ l i v ɐ 
καμάρι	k ɐ m ɐ ɾ i 
καμιάν	k ɐ m i ɐ n̪ 
καμμία	k ɐ m i ɐ 
κανένα	k ɐ n̪ ɛ n̪ ɐ 
κανείς	k ɐ n̪ i s 
καράβι	k ɐ ɾ ɐ v i 
καρδιά	k ɐ ɾ ð i ɐ 
καρποί	k ɐ ɾ p i 
καρπός	k ɐ ɾ p o s 
καρότα	k ɐ ɾ o t̪ ɐ 
κατάρα	k ɐ t̪ ɐ ɾ ɐ 
κατέβω	k ɐ t̪ ɛ v o 
κελάρι	k ɛ l ɐ ɾ i 
κεφάλι	k ɛ f ɐ l i 
κινητό	k i n̪ i t̪ o 
κλέφτη	k l ɛ f t̪ i 
κλέψει	k l ɛ p s i 
κλήσης	k l i s i s 
κλαίει	k l ɛ i 
κλαδιά	k l ɐ ð i ɐ 
κλειδί	k l i ð i 
κλοπής	k l o p i s 
κλωστή	k l o s t̪ i 
κοιλιά	k i l i ɐ 
κοινός	k i n̪ o s 
κοιτάς	k i t̪ ɐ s 
κοντός	k o d̪ o s 
κοπάδι	k o p ɐ ð i 
κοπέλα	k o p ɛ l ɐ 
κοπέλι	k o p ɛ l i 
κορμός	k o ɾ m o s 
κορυφή	k o ɾ i f i 
κορώνα	k o ɾ o n̪ ɐ 
κουκιά	k u k i ɐ 
κουλού	k u l u 
κουλός	k u l o s 
κουμπί	k u b i 
κουτσή	k u t̪ s i 
κουτσό	k u t̪ s o 
κουτός	k u t̪ o s 
κοφίνι	k o f i n̪ i 
κούτσα	k u t̪ s ɐ 
κράτος	k ɾ ɐ t̪ o s 
κρίσης	k ɾ i s i s 
κρύψει	k ɾ i p s i 
κυνήγι	k i n̪ i ɣ i 
κυπριά	k i p ɾ i ɐ 
κυρίως	k i ɾ i o s 
κόβαμε	k o v ɐ m ɛ 
κόκαλα	k o k ɐ l ɐ 
κόμποι	k o b i 
κόπηκε	k o p i k ɛ 
κόσμον	k o s m o n̪ 
κόσμος	k o s m o s 
κόσμου	k o s m u 
κόψανε	k o p s ɐ n̪ ɛ 
κόψουν	k o p s u n̪ 
κύριοι	k i ɾ i 
κύριος	k i ɾ i o s 
λάπτοπ	l ɐ p t̪ o p 
λέξεις	l ɛ k s i s 
λίγους	l i ɣ u s 
λαιμού	l ɛ m u 
λαιμός	l ɛ m o s 
λαμπρά	l ɐ b ɾ ɐ 
λαμπρό	l ɐ b ɾ o 
λαφριά	l ɐ f ɾ i ɐ 
λείπει	l i p i 
λιγάκι	l i ɣ ɐ k i 
λογικό	l o ɣ i k o 
λοιπόν	l i p o n̪ 
λυγερή	l i ɣ ɛ ɾ i 
λόγχες	l o ɣ x ɛ s 
λόφους	l o f u s 
λύθηκε	l i θ i k ɛ 
μάζευε	m ɐ z ɛ v ɛ 
μάζεψα	m ɐ z ɛ p s ɐ 
μάζεψε	m ɐ z ɛ p s ɛ 
μάθαμε	m ɐ θ ɐ m ɛ 
μάθεις	m ɐ θ i s 
μάθετε	m ɐ θ ɛ t̪ ɛ 
μάθημα	m ɐ θ i m ɐ 
μάθομε	m ɐ θ o m ɛ 
μάθουν	m ɐ θ u n̪ 
μάλαμα	m ɐ l ɐ m ɐ 
μάλλον	m ɐ l o n̪ 
μάταια	m ɐ t̪ ɛ ɐ 
μάτωνε	m ɐ t̪ o n̪ ɛ 
μέλλον	m ɛ l o n̪ 
μένετε	m ɛ n̪ ɛ t̪ ɛ 
μένουν	m ɛ n̪ u n̪ 
μέτρων	m ɛ t̪ ɾ o n̪ 
μέτωπο	m ɛ t̪ o p o 
μέτωπό	m ɛ t̪ o p o 
μήνυμα	m i n̪ i m ɐ 
μήνυσα	m i n̪ i s ɐ 
μίλησε	m i l i s ɛ 
μαγαζί	m ɐ ɣ ɐ z i 
μαζέψω	m ɐ z ɛ p s o 
μακριά	m ɐ k ɾ i ɐ 
μακρύς	m ɐ k ɾ i s 
μαλλιά	m ɐ l i ɐ 
μανίκι	m ɐ n̪ i k i 
μανδύα	m ɐ n̪ ð i ɐ 
ματιάς	m ɐ t̪ i ɐ s 
ματιές	m ɐ t̪ i ɛ s 
μαϊμού	m ɐ i m u 
μαύρες	m ɐ v ɾ ɛ s 
μαύροι	m ɐ v ɾ i 
μείνει	m i n̪ i 
μεγάλα	m ɛ ɣ ɐ l ɐ 
μεγάλη	m ɛ ɣ ɐ l i 
μεγάλο	m ɛ ɣ ɐ l o 
μεθύσι	m ɛ θ i s i 
μερικά	m ɛ ɾ i k ɐ 
μεταξύ	m ɛ t̪ ɐ k s i 
μητέρα	m i t̪ ɛ ɾ ɐ 
μικρές	m i k ɾ ɛ s 
μικρός	m i k ɾ o s 
μιλάνε	m i l ɐ n̪ ɛ 
μιλήσω	m i l i s o 
μνήμης	m n̪ i m i s 
μολύβι	m o l i v i 
μονάχα	m o n̪ ɐ x ɐ 
μπάγκο	b ɐ ɡ o 
μπάτσο	b ɐ t̪ s o 
μπήκαν	b i k ɐ n̪ 
μπήκες	b i k ɛ s 
μπήξει	b i k s i 
μπορεί	b o ɾ i 
μπούμε	b u m ɛ 
μπράβο	b ɾ ɐ v o 
μπύρες	b i ɾ ɛ s 
μύρισε	m i ɾ i s ɛ 
νίκησε	n̪ i k i s ɛ 
ναύτες	n̪ ɐ f t̪ ɛ s 
ναύτης	n̪ ɐ f t̪ i s 
νιώσει	n̪ i o s i 
ντροπή	d̪ ɾ o p i 
νύχτας	n̪ i x t̪ ɐ s 
ξέκοβε	k s ɛ k o v ɛ 
ξένους	k s ɛ n̪ u s 
ξέπεσε	k s ɛ p ɛ s ɛ 
ξέραμε	k s ɛ ɾ ɐ m ɛ 
ξέρεις	k s ɛ ɾ i s 
ξέρομε	k s ɛ ɾ o m ɛ 
ξέρουν	k s ɛ ɾ u n̪ 
ξέφυγε	k s ɛ f i ɣ ɛ 
ξέχασα	k s ɛ x ɐ s ɐ 
ξήλωσε	k s i l o s ɛ 
ξεφύγω	k s ɛ f i ɣ o 
ξεχάσω	k s ɛ x ɐ s o 
ξεχνάς	k s ɛ x n̪ ɐ s 
ξύλινα	k s i l i n̪ ɐ 
ξύλινη	k s i l i n̪ i 
ξύλινο	k s i l i n̪ o 
ογδόου	o ɣ ð o u 
οδηγεί	o ð i ɣ i 
οδηγός	o ð i ɣ o s 
ολοένα	o l o ɛ n̪ ɐ 
ολονών	o l o n̪ o n̪ 
ολόρθα	o l o ɾ θ ɐ 
ομιλία	o m i l i ɐ 
οποίας	o p i ɐ s 
οποίος	o p i o s 
οπόταν	o p o t̪ ɐ n̪ 
ουρανό	u ɾ ɐ n̪ o 
πάγκου	p ɐ ɡ u 
πάλευε	p ɐ l ɛ v ɛ 
πάπιας	p ɐ p i ɐ s 
πάπιες	p ɐ p i ɛ s 
πάρεις	p ɐ ɾ i s 
πάτησε	p ɐ t̪ i s ɛ 
πάτωμα	p ɐ t̪ o m ɐ 
πέδιλα	p ɛ ð i l ɐ 
πέθανε	p ɛ θ ɐ n̪ ɛ 
πέρασε	p ɛ ɾ ɐ s ɛ 
πέρναα	p ɛ ɾ n̪ ɐ 
πέταξα	p ɛ t̪ ɐ k s ɐ 
πέταξε	p ɛ t̪ ɐ k s ɛ 
πέτρες	p ɛ t̪ ɾ ɛ s 
πέτυχα	p ɛ t̪ i x ɐ 
πέτυχε	p ɛ t̪ i x ɛ 
πέφτει	p ɛ f t̪ i 
πήγαμε	p i ɣ ɐ m ɛ 
πήδημα	p i ð i m ɐ 
πήδηξε	p i ð i k s ɛ 
πίκρες	p i k ɾ ɛ s 
πίνακα	p i n̪ ɐ k ɐ 
πίνουν	p i n̪ u n̪ 
παίξει	p ɛ k s i 
παιδιά	p ɛ ð i ɐ 
παλάμη	p ɐ l ɐ m i 
παλάτι	p ɐ l ɐ t̪ i 
πανέρι	p ɐ n̪ ɛ ɾ i 
πανικό	p ɐ n̪ i k o 
παντού	p ɐ d̪ u 
παππού	p ɐ p u 
πατάει	p ɐ t̪ ɐ i 
πατέρα	p ɐ t̪ ɛ ɾ ɐ 
πατίνι	p ɐ t̪ i n̪ i 
παύλες	p ɐ v l ɛ s 
πείσει	p i s i 
πεθάνω	p ɛ θ ɐ n̪ o 
πελάτη	p ɛ l ɐ t̪ i 
περάσω	p ɛ ɾ ɐ s o 
πετριά	p ɛ t̪ ɾ i ɐ 
πηγάδι	p i ɣ ɐ ð i 
πιάνει	p i ɐ n̪ i 
πιάσει	p i ɐ s i 
πιέσει	p i ɛ s i 
πιστός	p i s t̪ o s 
πλένει	p l ɛ n̪ i 
πλέρια	p l ɛ ɾ i ɐ 
πλήθος	p l i θ o s 
πλευρά	p l ɛ v ɾ ɐ 
πλευρό	p l ɛ v ɾ o 
πλούτη	p l u t̪ i 
πλωτές	p l o t̪ ɛ s 
πνιγεί	p n̪ i ɣ i 
πολέμα	p o l ɛ m ɐ 
πολλές	p o l ɛ s 
πολλήν	p o l i n̪ 
πολλοί	p o l i 
πονηρή	p o n̪ i ɾ i 
ποτάμι	p o t̪ ɐ m i 
ποτήρι	p o t̪ i ɾ i 
ποταμό	p o t̪ ɐ m o 
πουγγί	p u ɡ i 
πουλάς	p u l ɐ s 
πουλιά	p u l i ɐ 
πράγμα	p ɾ ɐ ɣ m ɐ 
πράξης	p ɾ ɐ k s i s 
πρέπει	p ɾ ɛ p i 
προτού	p ɾ o t̪ u 
προφίλ	p ɾ o f i l 
προϊόν	p ɾ o i o n̪ 
πρωινή	p ɾ o i n̪ i 
πρωινό	p ɾ o i n̪ o 
πρώτες	p ɾ o t̪ ɛ s 
πρώτος	p ɾ o t̪ o s 
πόλεμο	p o l ɛ m o 
πόρτες	p o ɾ t̪ ɛ s 
πύργος	p i ɾ ɣ o s 
πύργου	p i ɾ ɣ u 
ράβεις	ɾ ɐ v i s 
ράφτρα	ɾ ɐ f t̪ ɾ ɐ 
ρίγανη	ɾ i ɣ ɐ n̪ i 
ρίζωμα	ɾ i z o m ɐ 
ρίξουν	ɾ i k s u n̪ 
ρούχου	ɾ u x u 
ρωτήσω	ɾ o t̪ i s o 
ρόδινα	ɾ o ð i n̪ ɐ 
ρώτησα	ɾ o t̪ i s ɐ 
ρώτησε	ɾ o t̪ i s ɛ 
σάβανο	s ɐ v ɐ n̪ o 
σάλεψε	s ɐ l ɛ p s ɛ 
σέρνει	s ɛ ɾ n̪ i 
σήκωνε	s i k o n̪ ɛ 
σήκωσε	s i k o s ɛ 
σήμερα	s i m ɛ ɾ ɐ 
σίδερα	s i ð ɛ ɾ ɐ 
σίδερο	s i ð ɛ ɾ o 
σίμωσε	s i m o s ɛ 
σαΐτες	s ɐ i t̪ ɛ s 
σαίτες	s ɛ t̪ ɛ s 
σαγόνι	s ɐ ɣ o n̪ i 
σανίδα	s ɐ n̪ i ð ɐ 
σβηστή	s v i s t̪ i 
σγουρά	s ɣ u ɾ ɐ 
σγουρό	s ɣ u ɾ o 
σελίδα	s ɛ l i ð ɐ 
σηκωθώ	s i k o θ o 
σηκώσω	s i k o s o 
σημάδι	s i m ɐ ð i 
σημεία	s i m i ɐ 
σημείο	s i m i o 
σιγανά	s i ɣ ɐ n̪ ɐ 
σιδερά	s i ð ɛ ɾ ɐ 
σιτάρι	s i t̪ ɐ ɾ i 
σκάβει	s k ɐ v i 
σκάψει	s k ɐ p s i 
σκίνος	s k i n̪ o s 
σκαμνί	s k ɐ m n̪ i 
σκηνές	s k i n̪ ɛ s 
σκιερή	s k i ɛ ɾ i 
σκληρό	s k l i ɾ o 
σκοινί	s k i n̪ i 
σκοπού	s k o p u 
σκουφί	s k u f i 
σκούπα	s k u p ɐ 
σκούρα	s k u ɾ ɐ 
σκυλιά	s k i l i ɐ 
σκυφτό	s k i f t̪ o 
σμίγει	s m i ɣ i 
σοβαρά	s o v ɐ ɾ ɐ 
σοβαρό	s o v ɐ ɾ o 
σούπες	s u p ɛ s 
σπίνος	s p i n̪ o s 
σπίτια	s p i t̪ i ɐ 
σπαθιά	s p ɐ θ i ɐ 
σπούσα	s p u s ɐ 
στάλες	s t̪ ɐ l ɛ s 
στάμνα	s t̪ ɐ m n̪ ɐ 
στέκει	s t̪ ɛ k i 
στέλνω	s t̪ ɛ l n̪ o 
στέμμα	s t̪ ɛ m ɐ 
στήθια	s t̪ i θ i ɐ 
στήθος	s t̪ i θ o s 
στίξης	s t̪ i k s i s 
στείλω	s t̪ i l o 
στείλ’	s t̪ i l 
στεγνή	s t̪ ɛ ɣ n̪ i 
στεριά	s t̪ ɛ ɾ i ɐ 
στιγμή	s t̪ i ɣ m i 
στοίβα	s t̪ i v ɐ 
στρίβω	s t̪ ɾ i v o 
στραβά	s t̪ ɾ ɐ v ɐ 
στραβή	s t̪ ɾ ɐ v i 
στρατό	s t̪ ɾ ɐ t̪ o 
στρώμα	s t̪ ɾ o m ɐ 
στόλος	s t̪ o l o s 
συμβεί	s i m v i 
συνάμα	s i n̪ ɐ m ɐ 
συνάχι	s i n̪ ɐ x i 
σφιχτά	s f i x t̪ ɐ 
σχέδια	s x ɛ ð i ɐ 
σχέδιο	s x ɛ ð i o 
σχεδόν	s x ɛ ð o n̪ 
σωθούν	s o θ u n̪ 
σύνεση	s i n̪ ɛ s i 
σύνορα	s i n̪ o ɾ ɐ 
σύρετε	s i ɾ ɛ t̪ ɛ 
σύρουν	s i ɾ u n̪ 
σώπασε	s o p ɐ s ɛ 
τάλιρα	t̪ ɐ l i ɾ ɐ 
τέτοια	t̪ ɛ t̪ i ɐ 
τέτοιο	t̪ ɛ t̪ i o 
τίμιοι	t̪ i m i 
τίμιος	t̪ i m i o s 
τίποτα	t̪ i p o t̪ ɐ 
τίποτε	t̪ i p o t̪ ɛ 
ταινία	t̪ ɛ n̪ i ɐ 
ταμείο	t̪ ɐ m i o 
ταξίδι	t̪ ɐ k s i ð i 
ταραχή	t̪ ɐ ɾ ɐ x i 
τελεία	t̪ ɛ l i ɐ 
τελικά	t̪ ɛ l i k ɐ 
τζάμια	t̪ z ɐ m i ɐ 
τοίχοι	t̪ i x i 
τούμπα	t̪ u b ɐ 
τούτον	t̪ u t̪ o n̪ 
τούτος	t̪ u t̪ o s 
τρέμει	t̪ ɾ ɛ m i 
τρέξει	t̪ ɾ ɛ k s i 
τρέχει	t̪ ɾ ɛ x i 
τρίβει	t̪ ɾ i v i 
τρίτος	t̪ ɾ i t̪ o s 
τρανός	t̪ ɾ ɐ n̪ o s 
τραπέζ	t̪ ɾ ɐ p ɛ z 
τρελός	t̪ ɾ ɛ l o s 
τρόμος	t̪ ɾ o m o s 
τρόπος	t̪ ɾ o p o s 
τρόπων	t̪ ɾ o p o n̪ 
τρύπες	t̪ ɾ i p ɛ s 
τρύπια	t̪ ɾ i p i ɐ 
τρώγει	t̪ ɾ o ɣ i 
τσάντα	t̪ s ɐ d̪ ɐ 
τσέπες	t̪ s ɛ p ɛ s 
τσίροι	t̪ s i ɾ i 
τυχερό	t̪ i x ɛ ɾ o 
τόσους	t̪ o s u s 
τύλιγε	t̪ i l i ɣ ɛ 
υπήρχε	i p i ɾ x ɛ 
φάγουν	f ɐ ɣ u n̪ 
φάκελο	f ɐ k ɛ l o 
φάνηκε	f ɐ n̪ i k ɛ 
φέρεις	f ɛ ɾ i s 
φέρετε	f ɛ ɾ ɛ t̪ ɛ 
φέρουν	f ɛ ɾ u n̪ 
φίλησε	f i l i s ɛ 
φίλους	f i l u s 
φαγάκι	f ɐ ɣ ɐ k i 
φανάρι	f ɐ n̪ ɐ ɾ i 
φαρδιά	f ɐ ɾ ð i ɐ 
φευγιό	f ɛ v ɣ i o 
φεύγει	f ɛ v ɣ i 
φθάνει	f θ ɐ n̪ i 
φθάσει	f θ ɐ s i 
φιλέψω	f i l ɛ p s o 
φιλικά	f i l i k ɐ 
φλέβες	f l ɛ v ɛ s 
φλόγας	f l o ɣ ɐ s 
φοβερά	f o v ɛ ɾ ɐ 
φορείς	f o ɾ i s 
φορτίο	f o ɾ t̪ i o 
φούστα	f u s t̪ ɐ 
φρέσκα	f ɾ ɛ s k ɐ 
φρενών	f ɾ ɛ n̪ o n̪ 
φρικτή	f ɾ i k t̪ i 
φριχτό	f ɾ i x t̪ o 
φρουρά	f ɾ u ɾ ɐ 
φρούτα	f ɾ u t̪ ɐ 
φρύδια	f ɾ i ð i ɐ 
φταίει	f t̪ ɛ i 
φτιάσε	f t̪ i ɐ s ɛ 
φτιάσω	f t̪ i ɐ s o 
φτωχοί	f t̪ o x i 
φτωχός	f t̪ o x o s 
φυλάγω	f i l ɐ ɣ o 
φυλακή	f i l ɐ k i 
φυσικά	f i s i k ɐ 
φυσική	f i s i k i 
φυσικό	f i s i k o 
φυτεύω	f i t̪ ɛ v o 
φωλιές	f o l i ɛ s 
φωτίσω	f o t̪ i s o 
φόβους	f o v u s 
φόρεμά	f o ɾ ɛ m ɐ 
φόρεμα	f o ɾ ɛ m ɐ 
φύγαμε	f i ɣ ɐ m ɛ 
φύγανε	f i ɣ ɐ n̪ ɛ 
φύγατε	f i ɣ ɐ t̪ ɛ 
φύγεις	f i ɣ i s 
φύγετε	f i ɣ ɛ t̪ ɛ 
φύγομε	f i ɣ o m ɛ 
φύγουν	f i ɣ u n̪ 
φύλαξα	f i l ɐ k s ɐ 
φύλαξε	f i l ɐ k s ɛ 
φύσηξε	f i s i k s ɛ 
φώναζε	f o n̪ ɐ z ɛ 
φώναξε	f o n̪ ɐ k s ɛ 
φώτιζε	f o t̪ i z ɛ 
χάθηκε	x ɐ θ i k ɛ 
χάνεις	x ɐ n̪ i s 
χάνετε	x ɐ n̪ ɛ t̪ ɛ 
χάραξε	x ɐ ɾ ɐ k s ɛ 
χάρισε	x ɐ ɾ i s ɛ 
χάσεις	x ɐ s i s 
χαλάζι	x ɐ l ɐ z i 
χαλάσω	x ɐ l ɐ s o 
χαλαρή	x ɐ l ɐ ɾ i 
χαλούν	x ɐ l u n̪ 
χαμένα	x ɐ m ɛ n̪ ɐ 
χαμένο	x ɐ m ɛ n̪ o 
χαμηλή	x ɐ m i l i 
χαρίσω	x ɐ ɾ i s o 
χαρανί	x ɐ ɾ ɐ n̪ i 
χαρείς	x ɐ ɾ i s 
χαρτιά	x ɐ ɾ t̪ i ɐ 
χείλια	x i l i ɐ 
χημικά	x i m i k ɐ 
χιόνια	x i o n̪ i ɐ 
χλωμοί	x l o m i 
χλωμός	x l o m o s 
χοντρά	x o d̪ ɾ ɐ 
χοντρό	x o d̪ ɾ o 
χορούς	x o ɾ u s 
χρονών	x ɾ o n̪ o n̪ 
χρυσής	x ɾ i s i s 
χρόνια	x ɾ o n̪ i ɐ 
χτίζει	x t̪ i z i 
χωμένα	x o m ɛ n̪ ɐ 
χωρατά	x o ɾ ɐ t̪ ɐ 
χύθηκε	x i θ i k ɛ 
χώθηκε	x o θ i k ɛ 
χώματα	x o m ɐ t̪ ɐ 
χώριζε	x o ɾ i z ɛ 
χώρισε	x o ɾ i s ɛ 
χώσεις	x o s i s 
ψέματα	p s ɛ m ɐ t̪ ɐ 
ψημένα	p s i m ɛ n̪ ɐ 
ωστόσο	o s t̪ o s o 
όμορφα	o m o ɾ f ɐ 
όμορφη	o m o ɾ f i 
όμορφο	o m o ɾ f o 
όνειρο	o n̪ i ɾ o 
όποιον	o p i o n̪ 
όποιος	o p i o s 
όρθιου	o ɾ θ i u 
όρκους	o ɾ k u s 
όρμησε	o ɾ m i s ɛ 
όφελος	o f ɛ l o s 
ύπαρξη	i p ɐ ɾ k s i 
ύποπτη	i p o p t̪ i 
ύστερα	i s t̪ ɛ ɾ ɐ 
‘πεφτε	p ɛ f t̪ ɛ 
σχωρέσ'	s x o ɾ ɛ s 
χίλιες-δυο	x i l i ɛ s ð i o 
αστείο·	ɐ s t̪ i o 
Άδειασε	ɐ ð i ɐ s ɛ 
Άνθρωπε	ɐ n̪ θ ɾ o p ɛ 
Άνοιξαν	ɐ n̪ i k s ɐ n̪ 
Άρχισες	ɐ ɾ x i s ɛ s 
Άρχοντά	ɐ ɾ x o d̪ ɐ 
Άρχοντα	ɐ ɾ x o d̪ ɐ 
Έκλεισε	ɛ k l i s ɛ 
Έρχεσαι	ɛ ɾ x ɛ s ɛ 
Έσκασες	ɛ s k ɐ s ɛ s 
Έσπρωξε	ɛ s p ɾ o k s ɛ 
Έστειλε	ɛ s t̪ i l ɛ 
Έφθασαν	ɛ f θ ɐ s ɐ n̪ 
Αλήθεια	ɐ l i θ i ɐ 
Αλίμονα	ɐ l i m o n̪ ɐ 
Αμαρτία	ɐ m ɐ ɾ t̪ i ɐ 
Ανάβεις	ɐ n̪ ɐ v i s 
Ανάλογο	ɐ n̪ ɐ l o ɣ o 
Ανάμεσα	ɐ n̪ ɐ m ɛ s ɐ 
Αντάρας	ɐ d̪ ɐ ɾ ɐ s 
Αντίκρυ	ɐ d̪ i k ɾ i 
Αφέντης	ɐ f ɛ d̪ i s 
Αφεντιά	ɐ f ɛ d̪ i ɐ 
Βασιλιά	v ɐ s i l i ɐ 
Βγάζαμε	v ɣ ɐ z ɐ m ɛ 
Βλέπεις	v l ɛ p i s 
Βλέπετε	v l ɛ p ɛ t̪ ɛ 
Βρόντος	v ɾ o d̪ o s 
Γιώργος	ɣ i o ɾ ɣ o s 
Γρήγορα	ɣ ɾ i ɣ o ɾ ɐ 
Γραφείο	ɣ ɾ ɐ f i o 
Γυρεύει	ɣ i ɾ ɛ v i 
Γυρνάτε	ɣ i ɾ n̪ ɐ t̪ ɛ 
Γύρισαν	ɣ i ɾ i s ɐ n̪ 
Δεύτερη	ð ɛ f t̪ ɛ ɾ i 
Διάβασέ	ð i ɐ v ɐ s ɛ 
Διάταξε	ð i ɐ t̪ ɐ k s ɛ 
Δουλειά	ð u l i ɐ 
Δούλεψε	ð u l ɛ p s ɛ 
Δύσκολα	ð i s k o l ɐ 
Δύσκολο	ð i s k o l o 
Είμαστε	i m ɐ s t̪ ɛ 
Εκείνος	ɛ k i n̪ o s 
Εντάξει	ɛ d̪ ɐ k s i 
Ενόμιζα	ɛ n̪ o m i z ɐ 
Επείγει	ɛ p i ɣ i 
Εσπρέσο	ɛ s p ɾ ɛ s o 
Ευβοίας	ɛ v i ɐ s 
Ευτυχώς	ɛ f t̪ i x o s 
Θυμάσαι	θ i m ɐ s ɛ 
Θυμάστε	θ i m ɐ s t̪ ɛ 
Θυμήσου	θ i m i s u 
Κάθισαν	k ɐ θ i s ɐ n̪ 
Κάμποση	k ɐ b o s i 
Κάποιον	k ɐ p i o n̪ 
Κάποιος	k ɐ p i o s 
Καθήστε	k ɐ θ i s t̪ ɛ 
Καθίστε	k ɐ θ i s t̪ ɛ 
Κανέναν	k ɐ n̪ ɛ n̪ ɐ n̪ 
Κανένας	k ɐ n̪ ɛ n̪ ɐ s 
Καράβια	k ɐ ɾ ɐ v i ɐ 
Καταγής	k ɐ t̪ ɐ ɣ i s 
Κοίταζε	k i t̪ ɐ z ɛ 
Κοίταξε	k i t̪ ɐ k s ɛ 
Κοπελιά	k o p ɛ l i ɐ 
Κουκίδη	k u k i ð i 
Κράτους	k ɾ ɐ t̪ u s 
Κρέμασε	k ɾ ɛ m ɐ s ɛ 
Κυριακή	k i ɾ i ɐ k i 
Λείπουν	l i p u n̪ 
Λυπήσου	l i p i s u 
Μανούλα	m ɐ n̪ u l ɐ 
Μείναμε	m i n̪ ɐ m ɛ 
Μερικοί	m ɛ ɾ i k i 
Μοίρασε	m i ɾ ɐ s ɛ 
Μονάχος	m o n̪ ɐ x o s 
Μπορείς	b o ɾ i s 
Μπροστά	b ɾ o s t̪ ɐ 
Μυστική	m i s t̪ i k i 
Νομίζει	n̪ o m i z i 
Ξύπνησε	k s i p n̪ i s ɛ 
Οδήγησε	o ð i ɣ i s ɛ 
Πέρασαν	p ɛ ɾ ɐ s ɐ n̪ 
Πήγαινε	p i ɣ ɛ n̪ ɛ 
Πίστεψε	p i s t̪ ɛ p s ɛ 
Παλαβός	p ɐ l ɐ v o s 
Παναγία	p ɐ n̪ ɐ ɣ i ɐ 
Παναγιά	p ɐ n̪ ɐ ɣ i ɐ 
Παράδες	p ɐ ɾ ɐ ð ɛ s 
Πατρίδα	p ɐ t̪ ɾ i ð ɐ 
Παύσετε	p ɐ f s ɛ t̪ ɛ 
Πελεκάς	p ɛ l ɛ k ɐ s 
Περιττό	p ɛ ɾ i t̪ t̪ o 
Περπατά	p ɛ ɾ p ɐ t̪ ɐ 
Πλάκωσε	p l ɐ k o s ɛ 
Πληρώνω	p l i ɾ o n̪ o 
Προσοχή	p ɾ o s o x i 
Πρόεδρε	p ɾ o ɛ ð ɾ ɛ 
Πρόσεχε	p ɾ o s ɛ x ɛ 
Ραφαέλα	ɾ ɐ f ɐ ɛ l ɐ 
Σίγουρα	s i ɣ u ɾ ɐ 
Σιωπηλά	s i o p i l ɐ 
Σκάλισε	s k ɐ l i s ɛ 
Σκέψεις	s k ɛ p s i s 
Σκότωσε	s k o t̪ o s ɛ 
Σπάσετε	s p ɐ s ɛ t̪ ɛ 
Στάθηκε	s t̪ ɐ θ i k ɛ 
Στρατού	s t̪ ɾ ɐ t̪ u 
Στρατός	s t̪ ɾ ɐ t̪ o s 
Συγνώμη	s i ɣ n̪ o m i 
Συνετού	s i n̪ ɛ t̪ u 
Συνετός	s i n̪ ɛ t̪ o s 
Σχολείο	s x o l i o 
Σωκράτη	s o k ɾ ɐ t̪ i 
Τέτοιες	t̪ ɛ t̪ i ɛ s 
Τζοτζές	t̪ z o t̪ z ɛ s 
Τράβηξε	t̪ ɾ ɐ v i k s ɛ 
Τραβάτε	t̪ ɾ ɐ v ɐ t̪ ɛ 
Τρεχάτε	t̪ ɾ ɛ x ɐ t̪ ɛ 
Τρεχάτη	t̪ ɾ ɛ x ɐ t̪ i 
Τρομάρα	t̪ ɾ o m ɐ ɾ ɐ 
Υπάρχει	i p ɐ ɾ x i 
Φεύγεις	f ɛ v ɣ i s 
Φθάνουν	f θ ɐ n̪ u n̪ 
Φλουριά	f l u ɾ i ɐ 
Φοβέρας	f o v ɛ ɾ ɐ s 
Φραγκιά	f ɾ ɐ ɡ i ɐ 
Φτώχεια	f t̪ o x i ɐ 
Χτύπησε	x t̪ i p i s ɛ 
άδειασε	ɐ ð i ɐ s ɛ 
άκουσαν	ɐ k u s ɐ n̪ 
άκουσες	ɐ k u s ɛ s 
άλλαξαν	ɐ l ɐ k s ɐ n̪ 
άλλωστε	ɐ l o s t̪ ɛ 
άνθιζαν	ɐ n̪ θ i z ɐ n̪ 
άνθρωπε	ɐ n̪ θ ɾ o p ɛ 
άνθρωπο	ɐ n̪ θ ɾ o p o 
άνοστος	ɐ n̪ o s t̪ o s 
άπλυτες	ɐ p l i t̪ ɛ s 
άπλωσες	ɐ p l o s ɛ s 
άργησαν	ɐ ɾ ɣ i s ɐ n̪ 
άσπριζε	ɐ s p ɾ i z ɛ 
άχρηστα	ɐ x ɾ i s t̪ ɐ 
έβγαζαν	ɛ v ɣ ɐ z ɐ n̪ 
έβγαινε	ɛ v ɣ ɛ n̪ ɛ 
έβγαλαν	ɛ v ɣ ɐ l ɐ n̪ 
έβλεπες	ɛ v l ɛ p ɛ s 
έβοσκαν	ɛ v o s k ɐ n̪ 
έβρισκα	ɛ v ɾ i s k ɐ 
έβρισκε	ɛ v ɾ i s k ɛ 
έγραψαν	ɛ ɣ ɾ ɐ p s ɐ n̪ 
έδειξαν	ɛ ð i k s ɐ n̪ 
έδιωξαν	ɛ ð i o k s ɐ n̪ 
έκλαιγε	ɛ k l ɛ ɣ ɛ 
έκλεισε	ɛ k l i s ɛ 
έκλεψες	ɛ k l ɛ p s ɛ s 
έκπληξη	ɛ k p l i k s i 
έκσταση	ɛ k s t̪ ɐ s i 
έκτασης	ɛ k t̪ ɐ s i s 
έκφραση	ɛ k f ɾ ɐ s i 
έλειπαν	ɛ l i p ɐ n̪ 
έλειπες	ɛ l i p ɛ s 
έλειψες	ɛ l i p s ɛ s 
έμειναν	ɛ m i n̪ ɐ n̪ 
έμεινεν	ɛ m i n̪ ɛ n̪ 
έμοιαζε	ɛ m i ɐ z ɛ 
έπαιζαν	ɛ p ɛ z ɐ n̪ 
έπαιρνε	ɛ p ɛ ɾ n̪ ɛ 
έπαυσαν	ɛ p ɐ f s ɐ n̪ 
έπεφταν	ɛ p ɛ f t̪ ɐ n̪ 
έπιασαν	ɛ p i ɐ s ɐ n̪ 
έπλεκαν	ɛ p l ɛ k ɐ n̪ 
έρχεσαι	ɛ ɾ x ɛ s ɛ 
έρχεται	ɛ ɾ x ɛ t̪ ɛ 
έσερναν	ɛ s ɛ ɾ n̪ ɐ n̪ 
έσκυψαν	ɛ s k i p s ɐ n̪ 
έσπρωξε	ɛ s p ɾ o k s ɛ 
έστειλε	ɛ s t̪ i l ɛ 
έστελνε	ɛ s t̪ ɛ l n̪ ɛ 
έστριψε	ɛ s t̪ ɾ i p s ɛ 
έστρωσε	ɛ s t̪ ɾ o s ɛ 
έσφαζαν	ɛ s f ɐ z ɐ n̪ 
έσφιγγε	ɛ s f i ɡ ɛ 
έτοιμοι	ɛ t̪ i m i 
έτοιμος	ɛ t̪ i m o s 
έτρεξαν	ɛ t̪ ɾ ɛ k s ɐ n̪ 
έτρεχαν	ɛ t̪ ɾ ɛ x ɐ n̪ 
έτρωγαν	ɛ t̪ ɾ o ɣ ɐ n̪ 
έτσουξε	ɛ t̪ s u k s ɛ 
έφευγαν	ɛ f ɛ v ɣ ɐ n̪ 
έφθαναν	ɛ f θ ɐ n̪ ɐ n̪ 
έφθανες	ɛ f θ ɐ n̪ ɛ s 
έφθασαν	ɛ f θ ɐ s ɐ n̪ 
έφταιγε	ɛ f t̪ ɛ ɣ ɛ 
έφτιανα	ɛ f t̪ i ɐ n̪ ɐ 
έφτιαξε	ɛ f t̪ i ɐ k s ɛ 
έφτιασα	ɛ f t̪ i ɐ s ɐ 
έφτιασε	ɛ f t̪ i ɐ s ɛ 
ήμασταν	i m ɐ s t̪ ɐ n̪ 
ήσυχους	i s i x u s 
αίθουσα	ɛ θ u s ɐ 
αίματος	ɛ m ɐ t̪ o s 
αίσθηση	ɛ s θ i s i 
αγελάδα	ɐ ɣ ɛ l ɐ ð ɐ 
αγκάθια	ɐ ɡ ɐ θ i ɐ 
αγκαλιά	ɐ ɡ ɐ l i ɐ 
αγοριού	ɐ ɣ o ɾ i u 
αγόραζα	ɐ ɣ o ɾ ɐ z ɐ 
αγόρασα	ɐ ɣ o ɾ ɐ s ɐ 
αδέλφια	ɐ ð ɛ l f i ɐ 
αδειανά	ɐ ð i ɐ n̪ ɐ 
αδειανό	ɐ ð i ɐ n̪ o 
αδελφές	ɐ ð ɛ l f ɛ s 
αδελφής	ɐ ð ɛ l f i s 
αδελφοί	ɐ ð ɛ l f i 
αδελφού	ɐ ð ɛ l f u 
αδελφός	ɐ ð ɛ l f o s 
αδύναμα	ɐ ð i n̪ ɐ m ɐ 
αδύνατο	ɐ ð i n̪ ɐ t̪ o 
ακίνητα	ɐ k i n̪ i t̪ ɐ 
ακουμπά	ɐ k u b ɐ 
ακούσει	ɐ k u s i 
ακριβώς	ɐ k ɾ i v o s 
αλήθεια	ɐ l i θ i ɐ 
αληθινό	ɐ l i θ i n̪ o 
αλλάζει	ɐ l ɐ z i 
αλλάξει	ɐ l ɐ k s i 
αλυσίδα	ɐ l i s i ð ɐ 
αμάθητη	ɐ m ɐ θ i t̪ i 
αμέλεια	ɐ m ɛ l i ɐ 
αμαξάκι	ɐ m ɐ k s ɐ k i 
αμαρτία	ɐ m ɐ ɾ t̪ i ɐ 
αμπέλια	ɐ b ɛ l i ɐ 
ανάγκες	ɐ n̪ ɐ ɡ ɛ s 
ανάλογο	ɐ n̪ ɐ l o ɣ o 
ανάμεσά	ɐ n̪ ɐ m ɛ s ɐ 
ανάμεσα	ɐ n̪ ɐ m ɛ s ɐ 
ανάποδα	ɐ n̪ ɐ p o ð ɐ 
ανάψεις	ɐ n̪ ɐ p s i s 
ανέβηκε	ɐ n̪ ɛ v i k ɛ 
ανήξερο	ɐ n̪ i k s ɛ ɾ o 
ανήσυχα	ɐ n̪ i s i x ɐ 
ανήφορο	ɐ n̪ i f o ɾ o 
αναβολή	ɐ n̪ ɐ v o l i 
αναπνοή	ɐ n̪ ɐ p n̪ o i 
αναφέρω	ɐ n̪ ɐ f ɛ ɾ o 
ανοίξει	ɐ n̪ i k s i 
ανοησία	ɐ n̪ o i s i ɐ 
ανοιχτά	ɐ n̪ i x t̪ ɐ 
ανοιχτή	ɐ n̪ i x t̪ i 
ανοιχτό	ɐ n̪ i x t̪ o 
αντίκρυ	ɐ d̪ i k ɾ i 
αντρική	ɐ d̪ ɾ i k i 
ανωτέρω	ɐ n̪ o t̪ ɛ ɾ o 
αξίζουν	ɐ k s i z u n̪ 
απάθεια	ɐ p ɐ θ i ɐ 
απέθανε	ɐ p ɛ θ ɐ n̪ ɛ 
αποθήκη	ɐ p o θ i k i 
αποκάτω	ɐ p o k ɐ t̪ o 
αποκτάς	ɐ p o k t̪ ɐ s 
απολαβή	ɐ p o l ɐ v i 
αποπήρε	ɐ p o p i ɾ ɛ 
απόγεμα	ɐ p o ɣ ɛ m ɐ 
απόρησε	ɐ p o ɾ i s ɛ 
απότομα	ɐ p o t̪ o m ɐ 
απόφαση	ɐ p o f ɐ s i 
αρέσουν	ɐ ɾ ɛ s u n̪ 
αρκέσει	ɐ ɾ k ɛ s i 
αρπάξει	ɐ ɾ p ɐ k s i 
αρχίζει	ɐ ɾ x i z i 
αρχίσει	ɐ ɾ x i s i 
αρχηγός	ɐ ɾ x i ɣ o s 
ασθενής	ɐ s θ ɛ n̪ i s 
ασθενών	ɐ s θ ɛ n̪ o n̪ 
αστέρια	ɐ s t̪ ɛ ɾ i ɐ 
αστείος	ɐ s t̪ i o s 
αστικοί	ɐ s t̪ i k i 
αστικών	ɐ s t̪ i k o n̪ 
αστραπή	ɐ s t̪ ɾ ɐ p i 
ασχήμια	ɐ s x i m i ɐ 
ατάραχο	ɐ t̪ ɐ ɾ ɐ x o 
ατίμητα	ɐ t̪ i m i t̪ ɐ 
ατιμίες	ɐ t̪ i m i ɛ s 
αυθάδης	ɐ f θ ɐ ð i s 
αυριανή	ɐ v ɾ i ɐ n̪ i 
αυστηρά	ɐ f s t̪ i ɾ ɐ 
αφήνεις	ɐ f i n̪ i s 
αφήνουν	ɐ f i n̪ u n̪ 
αφήσεις	ɐ f i s i s 
αφήσουν	ɐ f i s u n̪ 
αφίξεων	ɐ f i k s ɛ o n̪ 
αφεντιά	ɐ f ɛ d̪ i ɐ 
αχτίδες	ɐ x t̪ i ð ɛ s 
αόριστα	ɐ o ɾ i s t̪ ɐ 
βάλθηκε	v ɐ l θ i k ɛ 
βάραθρο	v ɐ ɾ ɐ θ ɾ o 
βέβαιος	v ɛ v ɛ o s 
βαμμένα	v ɐ m ɛ n̪ ɐ 
βαρκάρη	v ɐ ɾ k ɐ ɾ i 
βασικού	v ɐ s i k u 
βαστούν	v ɐ s t̪ u n̪ 
βγάζομε	v ɣ ɐ z o m ɛ 
βγάζουν	v ɣ ɐ z u n̪ 
βγάλεις	v ɣ ɐ l i s 
βελόνες	v ɛ l o n̪ ɛ s 
βλάψουν	v l ɐ p s u n̪ 
βλέπεις	v l ɛ p i s 
βλέπομε	v l ɛ p o m ɛ 
βοήθεια	v o i θ i ɐ 
βοηθάει	v o i θ ɐ i 
βοηθήσω	v o i θ i s o 
βούκινο	v u k i n̪ o 
βούτυρο	v u t̪ i ɾ o 
βράχους	v ɾ ɐ x u s 
βρέθηκε	v ɾ ɛ θ i k ɛ 
βρήκαμε	v ɾ i k ɐ m ɛ 
βρίζουν	v ɾ i z u n̪ 
βρίσκει	v ɾ i s k i 
βραδινό	v ɾ ɐ ð i n̪ o 
βρεθούν	v ɾ ɛ θ u n̪ 
βρώμικα	v ɾ o m i k ɐ 
βρώμικο	v ɾ o m i k o 
γέλασαν	ɣ ɛ l ɐ s ɐ n̪ 
γέμιζαν	ɣ ɛ m i z ɐ n̪ 
γέμισαν	ɣ ɛ m i s ɐ n̪ 
γίνεται	ɣ i n̪ ɛ t̪ ɛ 
γίνηκαν	ɣ i n̪ i k ɐ n̪ 
γίνουμε	ɣ i n̪ u m ɛ 
γελαστά	ɣ ɛ l ɐ s t̪ ɐ 
γελαστή	ɣ ɛ l ɐ s t̪ i 
γεμάτες	ɣ ɛ m ɐ t̪ ɛ s 
γενικής	ɣ ɛ n̪ i k i s 
γενναία	ɣ ɛ n̪ n̪ ɛ ɐ 
γιαγιάς	ɣ i ɐ ɣ i ɐ s 
γιατρών	ɣ i ɐ t̪ ɾ o n̪ 
γκρεμνό	ɡ ɾ ɛ m n̪ o 
γλιτώσω	ɣ l i t̪ o s o 
γλυκάνω	ɣ l i k ɐ n̪ o 
γνωρίσω	ɣ n̪ o ɾ i s o 
γνώριζε	ɣ n̪ o ɾ i z ɛ 
γνώριμο	ɣ n̪ o ɾ i m o 
γνώρισε	ɣ n̪ o ɾ i s ɛ 
γράφετε	ɣ ɾ ɐ f ɛ t̪ ɛ 
γρήγορα	ɣ ɾ i ɣ o ɾ ɐ 
γρήγορο	ɣ ɾ i ɣ o ɾ o 
γραμμής	ɣ ɾ ɐ m i s 
γρασίδι	ɣ ɾ ɐ s i ð i 
γραφείο	ɣ ɾ ɐ f i o 
γριούλα	ɣ ɾ i u l ɐ 
γυάλιζε	ɣ i ɐ l i z ɛ 
γυμνούς	ɣ i m n̪ u s 
γυναίκα	ɣ i n̪ ɛ k ɐ 
γυρέψει	ɣ i ɾ ɛ p s i 
γυρίσει	ɣ i ɾ i s i 
γυρεύει	ɣ i ɾ ɛ v i 
γωνίτσα	ɣ o n̪ i t̪ s ɐ 
γύρευαν	ɣ i ɾ ɛ v ɐ n̪ 
γύριζαν	ɣ i ɾ i z ɐ n̪ 
γύρισαν	ɣ i ɾ i s ɐ n̪ 
γύρισες	ɣ i ɾ i s ɛ s 
γύρισμα	ɣ i ɾ i s m ɐ 
δάκτυλο	ð ɐ k t̪ i l o 
δάσκαλο	ð ɐ s k ɐ l o 
δάχτυλά	ð ɐ x t̪ i l ɐ 
δάχτυλα	ð ɐ x t̪ i l ɐ 
δάχτυλο	ð ɐ x t̪ i l o 
δέντρου	ð ɛ d̪ ɾ u 
δέντρων	ð ɛ d̪ ɾ o n̪ 
δέσποζε	ð ɛ s p o z ɛ 
δέχεσαι	ð ɛ x ɛ s ɛ 
δέχεται	ð ɛ x ɛ t̪ ɛ 
δέχθηκε	ð ɛ x θ i k ɛ 
δέχομαι	ð ɛ x o m ɛ 
δίκαιος	ð i k ɛ o s 
δίπλωμά	ð i p l o m ɐ 
δίπλωσε	ð i p l o s ɛ 
δίστασε	ð i s t̪ ɐ s ɛ 
δασικής	ð ɐ s i k i s 
δασικού	ð ɐ s i k u 
δείρετε	ð i ɾ ɛ t̪ ɛ 
δείρουν	ð i ɾ u n̪ 
δεμένες	ð ɛ m ɛ n̪ ɛ s 
δεσπότη	ð ɛ s p o t̪ i 
δεχθείς	ð ɛ x θ i s 
δεύτερη	ð ɛ f t̪ ɛ ɾ i 
δεύτερο	ð ɛ f t̪ ɛ ɾ o 
δηλωθεί	ð i l o θ i 
δημόσια	ð i m o s i ɐ 
διάβασε	ð i ɐ v ɐ s ɛ 
διάβολο	ð i ɐ v o l o 
διάθεσή	ð i ɐ θ ɛ s i 
διάθεση	ð i ɐ θ ɛ s i 
διάφανο	ð i ɐ f ɐ n̪ o 
διάφορα	ð i ɐ f o ɾ ɐ 
διέκοψε	ð i ɛ k o p s ɛ 
διέταξε	ð i ɛ t̪ ɐ k s ɛ 
διαβάσω	ð i ɐ v ɐ s o 
διαμάχη	ð i ɐ m ɐ x i 
διατάζω	ð i ɐ t̪ ɐ z o 
διαταγή	ð i ɐ t̪ ɐ ɣ i 
διδάσκω	ð i ð ɐ s k o 
δικάσει	ð i k ɐ s i 
δικαστή	ð i k ɐ s t̪ i 
διορίσω	ð i o ɾ i s o 
διώξομε	ð i o k s o m ɛ 
διώχνει	ð i o x n̪ i 
δουλέψω	ð u l ɛ p s o 
δουλεία	ð u l i ɐ 
δουλειά	ð u l i ɐ 
δουλεύω	ð u l ɛ v o 
δούλευα	ð u l ɛ v ɐ 
δούλευε	ð u l ɛ v ɛ 
δούλεψε	ð u l ɛ p s ɛ 
δροσερά	ð ɾ o s ɛ ɾ ɐ 
δροσερό	ð ɾ o s ɛ ɾ o 
δρόμους	ð ɾ o m u s 
δυνατόν	ð i n̪ ɐ t̪ o n̪ 
δυνατός	ð i n̪ ɐ t̪ o s 
δωμάτιά	ð o m ɐ t̪ i ɐ 
δωμάτια	ð o m ɐ t̪ i ɐ 
δωμάτιο	ð o m ɐ t̪ i o 
δωμάτιό	ð o m ɐ t̪ i o 
δύσκολα	ð i s k o l ɐ 
δύστυχη	ð i s t̪ i x i 
δώσουμε	ð o s u m ɛ 
είμαστε	i m ɐ s t̪ ɛ 
εβδόμου	ɛ v ð o m u 
εγέρασε	ɛ ɣ ɛ ɾ ɐ s ɛ 
εικόνες	i k o n̪ ɛ s 
εκάναμε	ɛ k ɐ n̪ ɐ m ɛ 
εκείνον	ɛ k i n̪ o n̪ 
εκείνος	ɛ k i n̪ o s 
ελέγξει	ɛ l ɛ ɣ k s i 
ελαφριά	ɛ l ɐ f ɾ i ɐ 
ελεεινό	ɛ l ɛ i n̪ o 
ελπίδες	ɛ l p i ð ɛ s 
εμβαδού	ɛ m v ɐ ð u 
εμπόριο	ɛ b o ɾ i o 
εννοείς	ɛ n̪ n̪ o i s 
εντελώς	ɛ d̪ ɛ l o s 
εξέτασε	ɛ k s ɛ t̪ ɐ s ɛ 
εξήγησε	ɛ k s i ɣ i s ɛ 
εξήγηση	ɛ k s i ɣ i s i 
εξηγείς	ɛ k s i ɣ i s 
εξώστης	ɛ k s o s t̪ i s 
επίθετα	ɛ p i θ ɛ t̪ ɐ 
επίπεδο	ɛ p i p ɛ ð o 
επιτύχω	ɛ p i t̪ i x o 
επόμενο	ɛ p o m ɛ n̪ o 
εργάτες	ɛ ɾ ɣ ɐ t̪ ɛ s 
εργασία	ɛ ɾ ɣ ɐ s i ɐ 
εργαστώ	ɛ ɾ ɣ ɐ s t̪ o 
ερείπια	ɛ ɾ i p i ɐ 
ερείπιο	ɛ ɾ i p i o 
ερχόταν	ɛ ɾ x o t̪ ɐ n̪ 
εσήμανε	ɛ s i m ɐ n̪ ɛ 
εσπρέσο	ɛ s p ɾ ɛ s o 
ευλογία	ɛ v l o ɣ i ɐ 
ευτυχία	ɛ f t̪ i x i ɐ 
εχθρική	ɛ x θ ɾ i k i 
εχθρικό	ɛ x θ ɾ i k o 
εχθρούς	ɛ x θ ɾ u s 
ζάλισες	z ɐ l i s ɛ s 
ζέστανε	z ɛ s t̪ ɐ n̪ ɛ 
ζήτησαν	z i t̪ i s ɐ n̪ 
ζαρώσει	z ɐ ɾ o s i 
ζευγάρι	z ɛ v ɣ ɐ ɾ i 
ζηλευτά	z i l ɛ f t̪ ɐ 
ζητήσει	z i t̪ i s i 
ζητιάνο	z i t̪ i ɐ n̪ o 
ζητούμε	z i t̪ u m ɛ 
ζητούσε	z i t̪ u s ɛ 
ζωντανή	z o d̪ ɐ n̪ i 
ησυχάσω	i s i x ɐ s o 
ησύχαζε	i s i x ɐ z ɛ 
ησύχασε	i s i x ɐ s ɛ 
θάμπωμα	θ ɐ b o m ɐ 
θέλησαν	θ ɛ l i s ɐ n̪ 
θέλησες	θ ɛ l i s ɛ s 
θέλουμε	θ ɛ l u m ɛ 
θανούσα	θ ɐ n̪ u s ɐ 
θαρρείς	θ ɐ ɾ i s 
θαύμασε	θ ɐ v m ɐ s ɛ 
θαύματα	θ ɐ v m ɐ t̪ ɐ 
θεωρείς	θ ɛ o ɾ i s 
θεόρατα	θ ɛ o ɾ ɐ t̪ ɐ 
θεόρατο	θ ɛ o ɾ ɐ t̪ o 
θεώρησε	θ ɛ o ɾ i s ɛ 
θησαυρό	θ i s ɐ v ɾ o 
θυμήσου	θ i m i s u 
θυμηθεί	θ i m i θ i 
θυμόταν	θ i m o t̪ ɐ n̪ 
θυμώνει	θ i m o n̪ i 
θόλωναν	θ o l o n̪ ɐ n̪ 
θώρακες	θ o ɾ ɐ k ɛ s 
ιατρικό	i ɐ t̪ ɾ i k o 
ιδρώτας	i ð ɾ o t̪ ɐ s 
ιστορία	i s t̪ o ɾ i ɐ 
κάθεσαι	k ɐ θ ɛ s ɛ 
κάθεστε	k ɐ θ ɛ s t̪ ɛ 
κάθεται	k ɐ θ ɛ t̪ ɛ 
κάθισαν	k ɐ θ i s ɐ n̪ 
κάθισες	k ɐ θ i s ɛ s 
κάθομαι	k ɐ θ o m ɛ 
κάμαρας	k ɐ m ɐ ɾ ɐ s 
κάμποσα	k ɐ b o s ɐ 
κάμποσο	k ɐ b o s o 
κάνουμε	k ɐ n̪ u m ɛ 
κάπνιζε	k ɐ p n̪ i z ɛ 
κάποιον	k ɐ p i o n̪ 
κάποιος	k ɐ p i o s 
κάρδαμα	k ɐ ɾ ð ɐ m ɐ 
κάρφωσε	k ɐ ɾ f o s ɛ 
κέντημα	k ɛ d̪ i m ɐ 
κέρδιζε	k ɛ ɾ ð i z ɛ 
κέρδισε	k ɛ ɾ ð i s ɛ 
κήρυξης	k i ɾ i k s i s 
κίνδυνο	k i n̪ ð i n̪ o 
καζάνια	k ɐ z ɐ n̪ i ɐ 
καημένο	k ɐ i m ɛ n̪ o 
καθένας	k ɐ θ ɛ n̪ ɐ s 
καθήκον	k ɐ θ i k o n̪ 
καθήστε	k ɐ θ i s t̪ ɛ 
καθενός	k ɐ θ ɛ n̪ o s 
καθόλου	k ɐ θ o l u 
καθόταν	k ɐ θ o t̪ ɐ n̪ 
καιρούς	k ɛ ɾ u s 
καλάμια	k ɐ l ɐ m i ɐ 
καλοζεί	k ɐ l o z i 
κανέναν	k ɐ n̪ ɛ n̪ ɐ n̪ 
κανένας	k ɐ n̪ ɛ n̪ ɐ s 
καράβια	k ɐ ɾ ɐ v i ɐ 
καρέγλα	k ɐ ɾ ɛ ɣ l ɐ 
καρέκλα	k ɐ ɾ ɛ k l ɐ 
καρπούς	k ɐ ɾ p u s 
καρτέλα	k ɐ ɾ t̪ ɛ l ɐ 
καστανά	k ɐ s t̪ ɐ n̪ ɐ 
κατέβει	k ɐ t̪ ɛ v i 
καταγής	k ɐ t̪ ɐ ɣ i s 
κατσίκι	k ɐ t̪ s i k i 
κατώφλι	k ɐ t̪ o f l i 
καφεΐνη	k ɐ f ɛ i n̪ i 
κείμενο	k i m ɛ n̪ o 
κείνους	k i n̪ u s 
κεφάλια	k ɛ f ɐ l i ɐ 
κλάματα	k l ɐ m ɐ t̪ ɐ 
κλέβουν	k l ɛ v u n̪ 
κλέφτες	k l ɛ f t̪ ɛ s 
κλέφτης	k l ɛ f t̪ i s 
κλέψανε	k l ɛ p s ɐ n̪ ɛ 
κλέψουν	k l ɛ p s u n̪ 
κλείσει	k l i s i 
κλειδιά	k l i ð i ɐ 
κλειστό	k l i s t̪ o 
κλεψιές	k l ɛ p s i ɛ s 
κλωστές	k l o s t̪ ɛ s 
κλωτσιά	k l o t̪ s i ɐ 
κλώσετε	k l o s ɛ t̪ ɛ 
κοίταζα	k i t̪ ɐ z ɐ 
κοίταζε	k i t̪ ɐ z ɛ 
κοίταξε	k i t̪ ɐ k s ɛ 
κοιμηθώ	k i m i θ o 
κοιτάει	k i t̪ ɐ i 
κομμάτι	k o m ɐ t̪ i 
κομμένη	k o m ɛ n̪ i 
κομμένο	k o m ɛ n̪ o 
κονσόλα	k o n̪ s o l ɐ 
κοντάρι	k o d̪ ɐ ɾ i 
κοπάδια	k o p ɐ ð i ɐ 
κοπέλας	k o p ɛ l ɐ s 
κορίτσι	k o ɾ i t̪ s i 
κορμούς	k o ɾ m u s 
κορώνας	k o ɾ o n̪ ɐ s 
κοταριό	k o t̪ ɐ ɾ i o 
κουβάρι	k u v ɐ ɾ i 
κουβαλά	k u v ɐ l ɐ 
κουζίνα	k u z i n̪ ɐ 
κουνέλι	k u n̪ ɛ l i 
κουρέλι	k u ɾ ɛ l i 
κουτσός	k u t̪ s o s 
κουφούς	k u f u s 
κούμαρα	k u m ɐ ɾ ɐ 
κούνησε	k u n̪ i s ɛ 
κούραση	k u ɾ ɐ s i 
κράτους	k ɾ ɐ t̪ u s 
κρέμασε	k ɾ ɛ m ɐ s ɛ 
κρεβάτι	k ɾ ɛ v ɐ t̪ i 
κρεμάσω	k ɾ ɛ m ɐ s o 
κριθάρι	k ɾ i θ ɐ ɾ i 
κτήματα	k t̪ i m ɐ t̪ ɐ 
κυβερνά	k i v ɛ ɾ n̪ ɐ 
κυλήσει	k i l i s i 
κυνηγάς	k i n̪ i ɣ ɐ s 
κυπριού	k i p ɾ i u 
κυπριών	k i p ɾ i o n̪ 
κυψέλες	k i p s ɛ l ɛ s 
κόκκινη	k o k i n̪ i 
κόκκινο	k o k i n̪ o 
κόμπους	k o b u s 
κόπηκαν	k o p i k ɐ n̪ 
κόσκινο	k o s k i n̪ o 
κόσμους	k o s m u s 
κόστιζε	k o s t̪ i z ɛ 
κότσυφα	k o t̪ s i f ɐ 
λήθαργο	l i θ ɐ ɾ ɣ o 
λαμπάδα	l ɐ b ɐ ð ɐ 
λαρύγγι	l ɐ ɾ i ɡ i 
λαχτάρα	l ɐ x t̪ ɐ ɾ ɐ 
λείπουν	l i p u n̪ 
λεβέντη	l ɛ v ɛ d̪ i 
λεκέδες	l ɛ k ɛ ð ɛ s 
λιακάδα	l i ɐ k ɐ ð ɐ 
λιγοστά	l i ɣ o s t̪ ɐ 
λιθάρια	l i θ ɐ ɾ i ɐ 
λιωμένα	l i o m ɛ n̪ ɐ 
λιωμένο	l i o m ɛ n̪ o 
λιώσουν	l i o s u n̪ 
λούφαξε	l u f ɐ k s ɛ 
λυγίσει	l i ɣ i s i 
λυγμούς	l i ɣ m u s 
λυπάμαι	l i p ɐ m ɛ 
λυπάσαι	l i p ɐ s ɛ 
λυπήσου	l i p i s u 
λύσουμε	l i s u m ɛ 
μάγειρα	m ɐ ɣ i ɾ ɐ 
μάγουλα	m ɐ ɣ u l ɐ 
μάγουλο	m ɐ ɣ u l o 
μάζεψαν	m ɐ z ɛ p s ɐ n̪ 
μάθησης	m ɐ θ i s i s 
μάλιστα	m ɐ l i s t̪ ɐ 
μέγαιρα	m ɛ ɣ ɛ ɾ ɐ 
μέλισσα	m ɛ l i s ɐ 
μέταλλο	m ɛ t̪ ɐ l o 
μίλησαν	m i l i s ɐ n̪ 
μαδούσε	m ɐ ð u s ɛ 
μαζέψει	m ɐ z ɛ p s i 
μαζεύει	m ɐ z ɛ v i 
μαθητές	m ɐ θ i t̪ ɛ s 
μανίκια	m ɐ n̪ i k i ɐ 
μαντίλι	m ɐ d̪ i l i 
μασούσε	m ɐ s u s ɛ 
μαστίχα	m ɐ s t̪ i x ɐ 
ματάκια	m ɐ t̪ ɐ k i ɐ 
μαχαίρι	m ɐ x ɛ ɾ i 
μείνανε	m i n̪ ɐ n̪ ɛ 
μείνεις	m i n̪ i s 
μείνετε	m i n̪ ɛ t̪ ɛ 
μείνομε	m i n̪ o m ɛ 
μείνουν	m i n̪ u n̪ 
μεγάλες	m ɛ ɣ ɐ l ɛ s 
μεγάλον	m ɛ ɣ ɐ l o n̪ 
μεθύσει	m ɛ θ i s i 
μερικές	m ɛ ɾ i k ɛ s 
μερικοί	m ɛ ɾ i k i 
μερτικό	m ɛ ɾ t̪ i k o 
μητέρας	m i t̪ ɛ ɾ ɐ s 
μιλήσει	m i l i s i 
μιλούσε	m i l u s ɛ 
μοίρασε	m i ɾ ɐ s ɛ 
μοιάζει	m i ɐ z i 
μονάχος	m o n̪ ɐ x o s 
μοναξιά	m o n̪ ɐ k s i ɐ 
μοναχοί	m o n̪ ɐ x i 
μουσική	m u s i k i 
μπλεχτώ	b l ɛ x t̪ o 
μπλούζα	b l u z ɐ 
μπορέσω	b o ɾ ɛ s o 
μπορείς	b o ɾ i s 
μπορούν	b o ɾ u n̪ 
μπουφάν	b u f ɐ n̪ 
μπράτσο	b ɾ ɐ t̪ s o 
μπροστά	b ɾ o s t̪ ɐ 
μπόλικα	b o l i k ɐ 
μπόρεσα	b o ɾ ɛ s ɐ 
μπόρεσε	b o ɾ ɛ s ɛ 
μυρωδιά	m i ɾ o ð i ɐ 
μυστικά	m i s t̪ i k ɐ 
μυστική	m i s t̪ i k i 
ναυτικό	n̪ ɐ f t̪ i k o 
νευρικά	n̪ ɛ v ɾ i k ɐ 
νευρικό	n̪ ɛ v ɾ i k o 
νιώθομε	n̪ i o θ o m ɛ 
νιώσεις	n̪ i o s i s 
νιώσουν	n̪ i o s u n̪ 
νομίζει	n̪ o m i z i 
νούμερα	n̪ u m ɛ ɾ ɐ 
νούμερο	n̪ u m ɛ ɾ o 
νούμερό	n̪ u m ɛ ɾ o 
νόστιμο	n̪ o s t̪ i m o 
ξέπλενε	k s ɛ p l ɛ n̪ ɛ 
ξέσπασε	k s ɛ s p ɐ s ɛ 
ξέχασαν	k s ɛ x ɐ s ɐ n̪ 
ξέχασες	k s ɛ x ɐ s ɛ s 
ξήρανση	k s i ɾ ɐ n̪ s i 
ξαναπεί	k s ɐ n̪ ɐ p i 
ξεπλύνω	k s ɛ p l i n̪ o 
ξεφύγει	k s ɛ f i ɣ i 
ξεχάσει	k s ɛ x ɐ s i 
ξυνήθρα	k s i n̪ i θ ɾ ɐ 
ξυπνήσω	k s i p n̪ i s o 
ξυπνητή	k s i p n̪ i t̪ i 
ξύπνησε	k s i p n̪ i s ɛ 
οδηγήσω	o ð i ɣ i s o 
οδηγίες	o ð i ɣ i ɛ s 
ολόγυρα	o l o ɣ i ɾ ɐ 
ολότελα	o l o t̪ ɛ l ɐ 
ομιλίες	o m i l i ɛ s 
ομορφιά	o m o ɾ f i ɐ 
ονοιχτο	o n̪ i x t̪ o 
ονόματα	o n̪ o m ɐ t̪ ɐ 
οπωρικά	o p o ɾ i k ɐ 
ορίσατε	o ɾ i s ɐ t̪ ɛ 
ορμόνες	o ɾ m o n̪ ɛ s 
πάντοτε	p ɐ d̪ o t̪ ɛ 
πάπλωμα	p ɐ p l o m ɐ 
πάρουμε	p ɐ ɾ u m ɛ 
πέρασαν	p ɛ ɾ ɐ s ɐ n̪ 
πέρασμά	p ɛ ɾ ɐ s m ɐ 
πέρναγε	p ɛ ɾ n̪ ɐ ɣ ɛ 
πέταξαν	p ɛ t̪ ɐ k s ɐ n̪ 
πέτρινη	p ɛ t̪ ɾ i n̪ i 
πέτσινη	p ɛ t̪ s i n̪ i 
πήγαινα	p i ɣ ɛ n̪ ɐ 
πήγαινε	p i ɣ ɛ n̪ ɛ 
πίστευε	p i s t̪ ɛ v ɛ 
πίστεψα	p i s t̪ ɛ p s ɐ 
παίρναν	p ɛ ɾ n̪ ɐ n̪ 
παίρνει	p ɛ ɾ n̪ i 
παγαίνω	p ɐ ɣ ɛ n̪ o 
παγώσει	p ɐ ɣ o s i 
παιδιού	p ɛ ð i u 
παλαβός	p ɐ l ɐ v o s 
πανέρια	p ɐ n̪ ɛ ɾ i ɐ 
πανικός	p ɐ n̪ i k o s 
παράδες	p ɐ ɾ ɐ ð ɛ s 
πατάτες	p ɐ t̪ ɐ t̪ ɛ s 
πατέρας	p ɐ t̪ ɛ ɾ ɐ s 
πατήσει	p ɐ t̪ i s i 
πατίνια	p ɐ t̪ i n̪ i ɐ 
πατρικό	p ɐ t̪ ɾ i k o 
παχουλά	p ɐ x u l ɐ 
πείραμα	p i ɾ ɐ m ɐ 
πεδιάδα	p ɛ ð i ɐ ð ɐ 
πεζούλι	p ɛ z u l i 
πεθαίνω	p ɛ θ ɛ n̪ o 
πεινούν	p i n̪ u n̪ 
περάσει	p ɛ ɾ ɐ s i 
περιττά	p ɛ ɾ i t̪ t̪ ɐ 
περιττό	p ɛ ɾ i t̪ t̪ o 
περπατά	p ɛ ɾ p ɐ t̪ ɐ 
πεσμένο	p ɛ s m ɛ n̪ o 
πετάξου	p ɛ t̪ ɐ k s u 
πετούσε	p ɛ t̪ u s ɛ 
πηγάδια	p i ɣ ɐ ð i ɐ 
πηγαίνω	p i ɣ ɛ n̪ o 
πιάσουν	p i ɐ s u n̪ 
πιατέλα	p i ɐ t̪ ɛ l ɐ 
πιρούνι	p i ɾ u n̪ i 
πιστέψω	p i s t̪ ɛ p s o 
πιστεύω	p i s t̪ ɛ v o 
πιωμένο	p i o m ɛ n̪ o 
πιότερο	p i o t̪ ɛ ɾ o 
πλάτανο	p l ɐ t̪ ɐ n̪ o 
πλήκτρα	p l i k t̪ ɾ ɐ 
πλήρωνε	p l i ɾ o n̪ ɛ 
πλήρωσα	p l i ɾ o s ɐ 
πλήρωσε	p l i ɾ o s ɛ 
πλαγινό	p l ɐ ɣ i n̪ o 
πλαδαρή	p l ɐ ð ɐ ɾ i 
πλατεία	p l ɐ t̪ i ɐ 
πληρωμή	p l i ɾ o m i 
πληρώθη	p l i ɾ o θ i 
πληρώνω	p l i ɾ o n̪ o 
πληρώσω	p l i ɾ o s o 
πλούσια	p l u s i ɐ 
πλούσιο	p l u s i o 
πλύνεις	p l i n̪ i s 
πονηριά	p o n̪ i ɾ i ɐ 
πονηρός	p o n̪ i ɾ o s 
πονούσα	p o n̪ u s ɐ 
ποτήρια	p o t̪ i ɾ i ɐ 
ποταμού	p o t̪ ɐ m u 
πουλήσω	p u l i s o 
πούλησε	p u l i s ɛ 
πούληση	p u l i s i 
πράματα	p ɾ ɐ m ɐ t̪ ɐ 
πράσινα	p ɾ ɐ s i n̪ ɐ 
πράσινη	p ɾ ɐ s i n̪ i 
πράσινο	p ɾ ɐ s i n̪ o 
προδότη	p ɾ o ð o t̪ i 
προλάβω	p ɾ o l ɐ v o 
προσοχή	p ɾ o s o x i 
προχθές	p ɾ o x θ ɛ s 
προωθεί	p ɾ o θ i 
πρωινής	p ɾ o i n̪ i s 
πρόβατα	p ɾ o v ɐ t̪ ɐ 
πρόλαβε	p ɾ o l ɐ v ɛ 
πρόσωπα	p ɾ o s o p ɐ 
πρόσωπο	p ɾ o s o p o 
πρόταση	p ɾ o t̪ ɐ s i 
πτέρυγα	p t̪ ɛ ɾ i ɣ ɐ 
ρέμβαζε	ɾ ɛ m v ɐ z ɛ 
ρήμαζαν	ɾ i m ɐ z ɐ n̪ 
ρήμαξαν	ɾ i m ɐ k s ɐ n̪ 
ρίξουμε	ɾ i k s u m ɛ 
ρίχθηκε	ɾ i x θ i k ɛ 
ρημάζει	ɾ i m ɐ z i 
ριχμένο	ɾ i x m ɛ n̪ o 
ρυακιού	ɾ i ɐ k i u 
ρωτήσει	ɾ o t̪ i s i 
ρώτησαν	ɾ o t̪ i s ɐ n̪ 
ρώτησες	ɾ o t̪ i s ɛ s 
σάπιζαν	s ɐ p i z ɐ n̪ 
σάστιση	s ɐ s t̪ i s i 
σέβεται	s ɛ v ɛ t̪ ɛ 
σήκωναν	s i k o n̪ ɐ n̪ 
σήκωσαν	s i k o s ɐ n̪ 
σήμανση	s i m ɐ n̪ s i 
σίγουρα	s i ɣ u ɾ ɐ 
σίμωναν	s i m o n̪ ɐ n̪ 
σίμωσαν	s i m o s ɐ n̪ 
σακούλα	s ɐ k u l ɐ 
σακούλι	s ɐ k u l i 
σεβασμό	s ɛ v ɐ s m o 
σελίδες	s ɛ l i ð ɛ s 
σηκωθεί	s i k o θ i 
σηκώνει	s i k o n̪ i 
σηκώσει	s i k o s i 
σημαίνω	s i m ɛ n̪ o 
σημασία	s i m ɐ s i ɐ 
σιδεράς	s i ð ɛ ɾ ɐ s 
σιτάρια	s i t̪ ɐ ɾ i ɐ 
σιωπηλά	s i o p i l ɐ 
σιωπηλή	s i o p i l i 
σκάβετε	s k ɐ v ɛ t̪ ɛ 
σκάβουν	s k ɐ v u n̪ 
σκάλισα	s k ɐ l i s ɐ 
σκάλισε	s k ɐ l i s ɛ 
σκάλωσε	s k ɐ l o s ɛ 
σκάψομε	s k ɐ p s o m ɛ 
σκέπαζα	s k ɛ p ɐ z ɐ 
σκέπαζε	s k ɛ p ɐ z ɛ 
σκέπασε	s k ɛ p ɐ s ɛ 
σκέψεις	s k ɛ p s i s 
σκήπτρο	s k i p t̪ ɾ o 
σκεφτεί	s k ɛ f t̪ i 
σκοινιά	s k i n̪ i ɐ 
σκορπάς	s k o ɾ p ɐ s 
σκοτάδι	s k o t̪ ɐ ð i 
σκοτώσω	s k o t̪ o s o 
σκούφια	s k u f i ɐ 
σκυλάκι	s k i l ɐ k i 
σκόρπια	s k o ɾ p i ɐ 
σκότισα	s k o t̪ i s ɐ 
σκότωσε	s k o t̪ o s ɛ 
σμέουρα	s m ɛ u ɾ ɐ 
σοβάδες	s o v ɐ ð ɛ s 
σοδειές	s o ð i ɛ s 
σοφίτας	s o f i t̪ ɐ s 
σπάσαμε	s p ɐ s ɐ m ɛ 
σπάσετε	s p ɐ s ɛ t̪ ɛ 
σπιτάκι	s p i t̪ ɐ k i 
σπιτιού	s p i t̪ i u 
σπούσαν	s p u s ɐ n̪ 
σπρωξιά	s p ɾ o k s i ɐ 
σπρώξει	s p ɾ o k s i 
στάθηκε	s t̪ ɐ θ i k ɛ 
στάχτες	s t̪ ɐ x t̪ ɛ s 
στέλνει	s t̪ ɛ l n̪ i 
στέναξε	s t̪ ɛ n̪ ɐ k s ɛ 
στήριξε	s t̪ i ɾ i k s ɛ 
σταθείς	s t̪ ɐ θ i s 
σταθερή	s t̪ ɐ θ ɛ ɾ i 
σταθερό	s t̪ ɐ θ ɛ ɾ o 
στείλει	s t̪ i l i 
στεφάνι	s t̪ ɛ f ɐ n̪ i 
στομάχι	s t̪ o m ɐ x i 
στρίψει	s t̪ ɾ i p s i 
στραβός	s t̪ ɾ ɐ v o s 
στρατού	s t̪ ɾ ɐ t̪ u 
στρατός	s t̪ ɾ ɐ t̪ o s 
στρωθεί	s t̪ ɾ o θ i 
στρώσει	s t̪ ɾ o s i 
συγγενή	s i ɡ ɛ n̪ i 
συγκαλά	s i ɡ ɐ l ɐ 
συγνώμη	s i ɣ n̪ o m i 
συγχωρώ	s i ɣ x o ɾ o 
συλλάβω	s i l ɐ v o 
συλλογή	s i l o ɣ i 
συνήλθε	s i n̪ i l θ ɛ 
συρτάρι	s i ɾ t̪ ɐ ɾ i 
σφύριξε	s f i ɾ i k s ɛ 
σχολείο	s x o l i o 
σχολική	s x o l i k i 
σωπάσει	s o p ɐ s i 
σύγχυση	s i ɣ x i s i 
σύζυγος	s i z i ɣ o s 
σύμβολο	s i m v o l o 
σύμφωνα	s i m f o n̪ ɐ 
σύννεφο	s i n̪ n̪ ɛ f o 
σύντομα	s i d̪ o m ɐ 
σύρουμε	s i ɾ u m ɛ 
σύσσωμο	s i s o m o 
σύστημα	s i s t̪ i m ɐ 
σύστησε	s i s t̪ i s ɛ 
σώπαινε	s o p ɛ n̪ ɛ 
τέσσερα	t̪ ɛ s ɛ ɾ ɐ 
τέτοιοι	t̪ ɛ t̪ i 
τέτοιον	t̪ ɛ t̪ i o n̪ 
τίτλους	t̪ i t̪ l u s 
ταβέρνα	t̪ ɐ v ɛ ɾ n̪ ɐ 
τακτικά	t̪ ɐ k t̪ i k ɐ 
ταλέντο	t̪ ɐ l ɛ d̪ o 
τελείες	t̪ ɛ l i ɛ s 
τελείως	t̪ ɛ l i o s 
τενεκές	t̪ ɛ n̪ ɛ k ɛ s 
τζοτζές	t̪ z o t̪ z ɛ s 
τοίχους	t̪ i x u s 
τολμήσω	t̪ o l m i s o 
τράβηξα	t̪ ɾ ɐ v i k s ɐ 
τράβηξε	t̪ ɾ ɐ v i k s ɛ 
τράπηκε	t̪ ɾ ɐ p i k ɛ 
τρέμανε	t̪ ɾ ɛ m ɐ n̪ ɛ 
τρέξεις	t̪ ɾ ɛ k s i s 
τρέξιμο	t̪ ɾ ɛ k s i m o 
τρέφεις	t̪ ɾ ɛ f i s 
τρέχεις	t̪ ɾ ɛ x i s 
τρέχετε	t̪ ɾ ɛ x ɛ t̪ ɛ 
τραβάτε	t̪ ɾ ɐ v ɐ t̪ ɛ 
τραπέζι	t̪ ɾ ɐ p ɛ z i 
τριάντα	t̪ ɾ i ɐ d̪ ɐ 
τρομάξω	t̪ ɾ o m ɐ k s o 
τρομάρα	t̪ ɾ o m ɐ ɾ ɐ 
τρομερό	t̪ ɾ o m ɛ ɾ o 
τροχούς	t̪ ɾ o x u s 
τρόπους	t̪ ɾ o p u s 
τρύπησε	t̪ ɾ i p i s ɛ 
τσάκισε	t̪ s ɐ k i s ɛ 
τσίρους	t̪ s i ɾ u s 
τσινάνε	t̪ s i n̪ ɐ n̪ ɛ 
τσοπάνη	t̪ s o p ɐ n̪ i 
τσούζει	t̪ s u z i 
τυφλούς	t̪ i f l u s 
τυχερές	t̪ i x ɛ ɾ ɛ s 
τύφλωνε	t̪ i f l o n̪ ɛ 
υγρασία	i ɣ ɾ ɐ s i ɐ 
υπάρχει	i p ɐ ɾ x i 
υπομονή	i p o m o n̪ i 
υπόληψη	i p o l i p s i 
φάνηκαν	f ɐ n̪ i k ɐ n̪ 
φάρμακα	f ɐ ɾ m ɐ k ɐ 
φάρμακό	f ɐ ɾ m ɐ k o 
φίλησαν	f i l i s ɐ n̪ 
φίλησες	f i l i s ɛ s 
φαρδείς	f ɐ ɾ ð i s 
φεγγάρι	f ɛ ɡ ɐ ɾ i 
φελούκα	f ɛ l u k ɐ 
φεύγετε	f ɛ v ɣ ɛ t̪ ɛ 
φεύγομε	f ɛ v ɣ o m ɛ 
φεύγουν	f ɛ v ɣ u n̪ 
φθάναμε	f θ ɐ n̪ ɐ m ɛ 
φθάνουν	f θ ɐ n̪ u n̪ 
φθάσεις	f θ ɐ s i s 
φθάσομε	f θ ɐ s o m ɛ 
φθάσουν	f θ ɐ s u n̪ 
φλουριά	f l u ɾ i ɐ 
φοβάμαι	f o v ɐ m ɛ 
φοβάσαι	f o v ɐ s ɛ 
φοβάστε	f o v ɐ s t̪ ɛ 
φοβηθεί	f o v i θ i 
φορεσιά	f o ɾ ɛ s i ɐ 
φορούσε	f o ɾ u s ɛ 
φούστας	f u s t̪ ɐ s 
φρίξεις	f ɾ i k s i s 
φταίγει	f t̪ ɛ ɣ i 
φτιάνει	f t̪ i ɐ n̪ i 
φτιάσει	f t̪ i ɐ s i 
φτωχικό	f t̪ o x i k o 
φτώχεια	f t̪ o x i ɐ 
φυλάγει	f i l ɐ ɣ i 
φυλακές	f i l ɐ k ɛ s 
φυλακής	f i l ɐ k i s 
φωνάζει	f o n̪ ɐ z i 
φωνάξει	f o n̪ ɐ k s i 
φωτεινά	f o t̪ i n̪ ɐ 
φωτεινή	f o t̪ i n̪ i 
φόρεσες	f o ɾ ɛ s ɛ s 
φόρτωμα	f o ɾ t̪ o m ɐ 
φόρτωσε	f o ɾ t̪ o s ɛ 
φύγουμε	f i ɣ u m ɛ 
φύλλωμα	f i l o m ɐ 
φώναζαν	f o n̪ ɐ z ɐ n̪ 
φώναξαν	f o n̪ ɐ k s ɐ n̪ 
φώναξες	f o n̪ ɐ k s ɛ s 
χάθηκαν	x ɐ θ i k ɐ n̪ 
χάιδευε	x ɐ i ð ɛ v ɛ 
χάιδεψε	x ɐ i ð ɛ p s ɛ 
χάνεται	x ɐ n̪ ɛ t̪ ɛ 
χάντρες	x ɐ d̪ ɾ ɛ s 
χάρισμα	x ɐ ɾ i s m ɐ 
χάσουμε	x ɐ s u m ɛ 
χαιρετά	x ɛ ɾ ɛ t̪ ɐ 
χαμπάρι	x ɐ b ɐ ɾ i 
χαρίζει	x ɐ ɾ i z i 
χαρίσει	x ɐ ɾ i s i 
χεράκια	x ɛ ɾ ɐ k i ɐ 
χοντροί	x o d̪ ɾ i 
χοντρός	x o d̪ ɾ o s 
χορτάρι	x o ɾ t̪ ɐ ɾ i 
χρεωστώ	x ɾ ɛ o s t̪ o 
χτίσεις	x t̪ i s i s 
χτυπάει	x t̪ i p ɐ i 
χτυπούν	x t̪ i p u n̪ 
χτύπησε	x t̪ i p i s ɛ 
χυδαίοι	x i ð ɛ i 
χωνέψει	x o n̪ ɛ p s i 
χωράφια	x o ɾ ɐ f i ɐ 
χωρίσει	x o ɾ i s i 
χωρικοί	x o ɾ i k i 
χωρικού	x o ɾ i k u 
χωρούσε	x o ɾ u s ɛ 
χύθηκαν	x i θ i k ɐ n̪ 
χώριζαν	x o ɾ i z ɐ n̪ 
ψάχνεις	p s ɐ x n̪ i s 
ψέλλισε	p s ɛ l i s ɛ 
ψηλώνει	p s i l o n̪ i 
ψημένες	p s i m ɛ n̪ ɛ s 
ωρολόγι	o ɾ o l o ɣ i 
ωφέλεια	o f ɛ l i ɐ 
όμοιους	o m i u s 
όμορφος	o m o ɾ f o s 
όμορφων	o m o ɾ f o n̪ 
ύπαρξής	i p ɐ ɾ k s i s 
Άνανδροι	ɐ n̪ ɐ n̪ ð ɾ i 
Άνθρωπος	ɐ n̪ θ ɾ o p o s 
Άρρωστος	ɐ ɾ o s t̪ o s 
Άρχοντας	ɐ ɾ x o d̪ ɐ s 
Έκλεισαν	ɛ k l i s ɐ n̪ 
Έρχονται	ɛ ɾ x o d̪ ɛ 
Έστειλαν	ɛ s t̪ i l ɐ n̪ 
Ανεβείτε	ɐ n̪ ɛ v i t̪ ɛ 
Ανυψώστε	ɐ n̪ i p s o s t̪ ɛ 
Αρχόντων	ɐ ɾ x o d̪ o n̪ 
Αφεντιάς	ɐ f ɛ d̪ i ɐ s 
Βαρέθηκα	v ɐ ɾ ɛ θ i k ɐ 
Βαρέθηκε	v ɐ ɾ ɛ θ i k ɛ 
Βαριόταν	v ɐ ɾ i o t̪ ɐ n̪ 
Βασιλεία	v ɐ s i l i ɐ 
Βασιλιάς	v ɐ s i l i ɐ s 
Βαστούσε	v ɐ s t̪ u s ɛ 
Βιάζομαι	v i ɐ z o m ɛ 
Βιαστικά	v i ɐ s t̪ i k ɐ 
Γίνονται	ɣ i n̪ o d̪ ɛ 
Γρήγορος	ɣ ɾ i ɣ o ɾ o s 
Γυναίκες	ɣ i n̪ ɛ k ɛ s 
Δίνοντας	ð i n̪ o d̪ ɐ s 
Διακοπές	ð i ɐ k o p ɛ s 
Διόρθωσέ	ð i o ɾ θ o s ɛ 
Δοκίμασα	ð o k i m ɐ s ɐ 
Δομίνικο	ð o m i n̪ i k o 
Δυστυχώς	ð i s t̪ i x o s 
Εμφάνιση	ɛ m f ɐ n̪ i s i 
Επίτροπε	ɛ p i t̪ ɾ o p ɛ 
Ευκαιρία	ɛ f k ɛ ɾ i ɐ 
Εφθάσαμε	ɛ f θ ɐ s ɐ m ɛ 
Θυμήθηκε	θ i m i θ i k ɛ 
Θυμούμαι	θ i m u m ɛ 
Ιστιαίας	i s t̪ i ɛ ɐ s 
Κάμποσες	k ɐ b o s ɛ s 
Κάμποσην	k ɐ b o s i n̪ 
Καρύστου	k ɐ ɾ i s t̪ u 
Κατάλαβα	k ɐ t̪ ɐ l ɐ v ɐ 
Κατέβηκε	k ɐ t̪ ɛ v i k ɛ 
Κατσίκες	k ɐ t̪ s i k ɛ s 
Κοιμάται	k i m ɐ t̪ ɛ 
Κοιμήσου	k i m i s u 
Κοιτάζει	k i t̪ ɐ z i 
Κοιτάξτε	k i t̪ ɐ k s t̪ ɛ 
Κοπιάστε	k o p i ɐ s t̪ ɛ 
Κουκάκης	k u k ɐ k i s 
Μαζέψετε	m ɐ z ɛ p s ɛ t̪ ɛ 
Μαραμένη	m ɐ ɾ ɐ m ɛ n̪ i 
Μονοχέρη	m o n̪ o x ɛ ɾ i 
Μπορείτε	b o ɾ i t̪ ɛ 
Μυστήριο	m i s t̪ i ɾ i o 
Νομάρχης	n̪ o m ɐ ɾ x i s 
Ξετύλιξε	k s ɛ t̪ i l i k s ɛ 
Ξυπνητός	k s i p n̪ i t̪ o s 
Πήγαιναν	p i ɣ ɛ n̪ ɐ n̪ 
Παράξενο	p ɐ ɾ ɐ k s ɛ n̪ o 
Παραγιός	p ɐ ɾ ɐ ɣ i o s 
Παρακάτω	p ɐ ɾ ɐ k ɐ t̪ o 
Παρακαλώ	p ɐ ɾ ɐ k ɐ l o 
Παραμύθι	p ɐ ɾ ɐ m i θ i 
Παρατάτε	p ɐ ɾ ɐ t̪ ɐ t̪ ɛ 
Πατρίδας	p ɐ t̪ ɾ i ð ɐ s 
Πατριώτη	p ɐ t̪ ɾ i o t̪ i 
Πεδιάδες	p ɛ ð i ɐ ð ɛ s 
Περίεργο	p ɛ ɾ i ɛ ɾ ɣ o 
Περίλυπη	p ɛ ɾ i l i p i 
Περνούμε	p ɛ ɾ n̪ u m ɛ 
Περνούσα	p ɛ ɾ n̪ u s ɐ 
Περνούσε	p ɛ ɾ n̪ u s ɛ 
Πολύδωρε	p o l i ð o ɾ ɛ 
Πολύδωρο	p o l i ð o ɾ o 
Πράγματι	p ɾ ɐ ɣ m ɐ t̪ i 
Προσπαθώ	p ɾ o s p ɐ θ o 
Προτείνω	p ɾ o t̪ i n̪ o 
Πρόσταξε	p ɾ o s t̪ ɐ k s ɛ 
Πρότεινε	p ɾ o t̪ i n̪ ɛ 
Σαπίζανε	s ɐ p i z ɐ n̪ ɛ 
Σαστίζει	s ɐ s t̪ i z i 
Σηκώθηκε	s i k o θ i k ɛ 
Σκέφθηκα	s k ɛ f θ i k ɐ 
Σκέφτηκε	s k ɛ f t̪ i k ɛ 
Σκούπισε	s k u p i s ɛ 
Στενεύει	s t̪ ɛ n̪ ɛ v i 
Στερέωσε	s t̪ ɛ ɾ ɛ o s ɛ 
Στρατηγέ	s t̪ ɾ ɐ t̪ i ɣ ɛ 
Συγυρίζω	s i ɣ i ɾ i z o 
Συνέχισε	s i n̪ ɛ x i s ɛ 
Τέσσερις	t̪ ɛ s ɛ ɾ i s 
Τελείωσε	t̪ ɛ l i o s ɛ 
Τρεχάτος	t̪ ɾ ɛ x ɐ t̪ o s 
Τρομάρας	t̪ ɾ o m ɐ ɾ ɐ s 
Φαίνεται	f ɛ n̪ ɛ t̪ ɛ 
Φαντάσου	f ɐ d̪ ɐ s u 
Φοβούμαι	f o v u m ɛ 
Φωνάξετε	f o n̪ ɐ k s ɛ t̪ ɛ 
Χιλιάδες	x i l i ɐ ð ɛ s 
Χτύπησαν	x t̪ i p i s ɐ n̪ 
άνθρωποι	ɐ n̪ θ ɾ o p i 
άνθρωπος	ɐ n̪ θ ɾ o p o s 
άρρωστος	ɐ ɾ o s t̪ o s 
άστραψαν	ɐ s t̪ ɾ ɐ p s ɐ n̪ 
άχρηστοι	ɐ x ɾ i s t̪ i 
έβγαιναν	ɛ v ɣ ɛ n̪ ɐ n̪ 
έβρισκαν	ɛ v ɾ i s k ɐ n̪ 
έβρισκες	ɛ v ɾ i s k ɛ s 
έκλεισαν	ɛ k l i s ɐ n̪ 
έκπληξης	ɛ k p l i k s i s 
έμπαιναν	ɛ b ɛ n̪ ɐ n̪ 
έπαιρναν	ɛ p ɛ ɾ n̪ ɐ n̪ 
έρχονταν	ɛ ɾ x o d̪ ɐ n̪ 
έστειλες	ɛ s t̪ i l ɛ s 
έφτιαχνε	ɛ f t̪ i ɐ x n̪ ɛ 
αγάπησες	ɐ ɣ ɐ p i s ɛ s 
αγέλαστο	ɐ ɣ ɛ l ɐ s t̪ o 
αγαπούσε	ɐ ɣ ɐ p u s ɛ 
αγελάδες	ɐ ɣ ɛ l ɐ ð ɛ s 
αγοράζει	ɐ ɣ o ɾ ɐ z i 
αγοράσει	ɐ ɣ o ɾ ɐ s i 
αγόραζες	ɐ ɣ o ɾ ɐ z ɛ s 
αδειάσει	ɐ ð i ɐ s i 
αδελφικά	ɐ ð ɛ l f i k ɐ 
αδελφούς	ɐ ð ɛ l f u s 
αδιάφορα	ɐ ð i ɐ f o ɾ ɐ 
αδιάφορη	ɐ ð i ɐ f o ɾ i 
αδύνατος	ɐ ð i n̪ ɐ t̪ o s 
αειφόρου	ɐ i f o ɾ u 
αθλητικά	ɐ θ l i t̪ i k ɐ 
αιώνιους	ɛ o n̪ i u s 
ακίνητοι	ɐ k i n̪ i t̪ i 
ακίνητος	ɐ k i n̪ i t̪ o s 
ακολούθα	ɐ k o l u θ ɐ 
ακούσεις	ɐ k u s i s 
ακούσουν	ɐ k u s u n̪ 
αλήθειες	ɐ l i θ i ɛ s 
αλλάξετε	ɐ l ɐ k s ɛ t̪ ɛ 
αλυσίδας	ɐ l i s i ð ɐ s 
αλυσίδες	ɐ l i s i ð ɛ s 
αμάθητος	ɐ m ɐ θ i t̪ o s 
ανάγκασε	ɐ n̪ ɐ ɡ ɐ s ɛ 
ανάδειξη	ɐ n̪ ɐ ð i k s i 
ανέβαινε	ɐ n̪ ɛ v ɛ n̪ ɛ 
ανέβηκαν	ɐ n̪ ɛ v i k ɐ n̪ 
ανήσυχες	ɐ n̪ i s i x ɛ s 
αναμμένα	ɐ n̪ ɐ m ɛ n̪ ɐ 
αναμμένη	ɐ n̪ ɐ m ɛ n̪ i 
αναμμένο	ɐ n̪ ɐ m ɛ n̪ o 
ανανέωσε	ɐ n̪ ɐ n̪ ɛ o s ɛ 
ανανδρία	ɐ n̪ ɐ n̪ ð ɾ i ɐ 
ανασάνει	ɐ n̪ ɐ s ɐ n̪ i 
ανατροφή	ɐ n̪ ɐ t̪ ɾ o f i 
ανησυχία	ɐ n̪ i s i x i ɐ 
ανθρώπου	ɐ n̪ θ ɾ o p u 
ανοίγεις	ɐ n̪ i ɣ i s 
ανοίξουν	ɐ n̪ i k s u n̪ 
ανοιχτές	ɐ n̪ i x t̪ ɛ s 
ανοιχτός	ɐ n̪ i x t̪ o s 
αντάμωσε	ɐ d̪ ɐ m o s ɛ 
αντίτιμο	ɐ d̪ i t̪ i m o 
ανώτερος	ɐ n̪ o t̪ ɛ ɾ o s 
απάντησε	ɐ p ɐ d̪ i s ɛ 
απάντηση	ɐ p ɐ d̪ i s i 
απέναντι	ɐ p ɛ n̪ ɐ d̪ i 
απέραντο	ɐ p ɛ ɾ ɐ d̪ o 
απλήρωτα	ɐ p l i ɾ o t̪ ɐ 
απλωμένο	ɐ p l o m ɛ n̪ o 
απλώθηκε	ɐ p l o θ i k ɛ 
αποθήκες	ɐ p o θ i k ɛ s 
αποκριές	ɐ p o k ɾ i ɛ s 
αποστάσω	ɐ p o s t̪ ɐ s o 
αποτελεί	ɐ p o t̪ ɛ l i 
απρόσωπη	ɐ p ɾ o s o p i 
απόγευμα	ɐ p o ɣ ɛ v m ɐ 
απόκριση	ɐ p o k ɾ i s i 
απόφασης	ɐ p o f ɐ s i s 
αργότερα	ɐ ɾ ɣ o t̪ ɛ ɾ ɐ 
αρθρώσει	ɐ ɾ θ ɾ o s i 
αριστερά	ɐ ɾ i s t̪ ɛ ɾ ɐ 
αριστερή	ɐ ɾ i s t̪ ɛ ɾ i 
αριστερό	ɐ ɾ i s t̪ ɛ ɾ o 
αρμάτωσε	ɐ ɾ m ɐ t̪ o s ɛ 
αρμέγεις	ɐ ɾ m ɛ ɣ i s 
αρνητικά	ɐ ɾ n̪ i t̪ i k ɐ 
ασημένια	ɐ s i m ɛ n̪ i ɐ 
ασημένιο	ɐ s i m ɛ n̪ i o 
ασθενείς	ɐ s θ ɛ n̪ i s 
ασθενούς	ɐ s θ ɛ n̪ u s 
ατάραχος	ɐ t̪ ɐ ɾ ɐ x o s 
αταραξία	ɐ t̪ ɐ ɾ ɐ k s i ɐ 
αυθάδεις	ɐ f θ ɐ ð i s 
αυριανός	ɐ v ɾ i ɐ n̪ o s 
αυτουνού	ɐ f t̪ u n̪ u 
αυτόματο	ɐ f t̪ o m ɐ t̪ o 
αφεντιάς	ɐ f ɛ d̪ i ɐ s 
βάζοντας	v ɐ z o d̪ ɐ s 
βαρέθηκα	v ɐ ɾ ɛ θ i k ɐ 
βαρέθηκε	v ɐ ɾ ɛ θ i k ɛ 
βασίλεια	v ɐ s i l i ɐ 
βασίλειο	v ɐ s i l i o 
βασίλειό	v ɐ s i l i o 
βασίλευε	v ɐ s i l ɛ v ɛ 
βασιλεία	v ɐ s i l i ɐ 
βασιλιάς	v ɐ s i l i ɐ s 
βασιλικά	v ɐ s i l i k ɐ 
βασιλικό	v ɐ s i l i k o 
βαστάξει	v ɐ s t̪ ɐ k s i 
βαστούσα	v ɐ s t̪ u s ɐ 
βαστούσε	v ɐ s t̪ u s ɛ 
βγαίνεις	v ɣ ɛ n̪ i s 
βιάζεσαι	v i ɐ z ɛ s ɛ 
βιαζόταν	v i ɐ z o t̪ ɐ n̪ 
βιαστικά	v i ɐ s t̪ i k ɐ 
βιαστική	v i ɐ s t̪ i k i 
βιαστικό	v i ɐ s t̪ i k o 
βιταμίνη	v i t̪ ɐ m i n̪ i 
βλάστηση	v l ɐ s t̪ i s i 
βοήθειας	v o i θ i ɐ s 
βοηθήσει	v o i θ i s i 
βοηθούσε	v o i θ u s ɛ 
βουτήξει	v u t̪ i k s i 
βουτήσει	v u t̪ i s i 
βρέθηκαν	v ɾ ɛ θ i k ɐ n̪ 
βρέθηκες	v ɾ ɛ θ i k ɛ s 
βρίσκαμε	v ɾ i s k ɐ m ɛ 
βρίσκεις	v ɾ i s k i s 
βρίσκουν	v ɾ i s k u n̪ 
βραχιόλι	v ɾ ɐ x i o l i 
γίνονται	ɣ i n̪ o d̪ ɛ 
γίνονταν	ɣ i n̪ o d̪ ɐ n̪ 
γείτονας	ɣ i t̪ o n̪ ɐ s 
γείτονες	ɣ i t̪ o n̪ ɛ s 
γειτονιά	ɣ i t̪ o n̪ i ɐ 
γελώντας	ɣ ɛ l o d̪ ɐ s 
γεμίζουν	ɣ ɛ m i z u n̪ 
γεννηθεί	ɣ ɛ n̪ n̪ i θ i 
γευθείτε	ɣ ɛ f θ i t̪ ɛ 
γιάτρεψε	ɣ i ɐ t̪ ɾ ɛ p s ɛ 
γιατρικό	ɣ i ɐ t̪ ɾ i k o 
γκρέμισε	ɡ ɾ ɛ m i s ɛ 
γκρεμνού	ɡ ɾ ɛ m n̪ u 
γκρεμούς	ɡ ɾ ɛ m u s 
γνωρίσει	ɣ n̪ o ɾ i s i 
γονάτισε	ɣ o n̪ ɐ t̪ i s ɛ 
γράμματα	ɣ ɾ ɐ m ɐ t̪ ɐ 
γραμμένα	ɣ ɾ ɐ m ɛ n̪ ɐ 
γραμμένη	ɣ ɾ ɐ m ɛ n̪ i 
γραμμένο	ɣ ɾ ɐ m ɛ n̪ o 
γυάλιζαν	ɣ i ɐ l i z ɐ n̪ 
γυαλάκια	ɣ i ɐ l ɐ k i ɐ 
γυναίκας	ɣ i n̪ ɛ k ɐ s 
γυναίκες	ɣ i n̪ ɛ k ɛ s 
γυρίζεις	ɣ i ɾ i z i s 
γυρίσεις	ɣ i ɾ i s i s 
γυρίσουν	ɣ i ɾ i s u n̪ 
γυρεύεις	ɣ i ɾ ɛ v i s 
γυρεύετε	ɣ i ɾ ɛ v ɛ t̪ ɛ 
δάσκαλος	ð ɐ s k ɐ l o s 
δέχθηκαν	ð ɛ x θ i k ɐ n̪ 
δίνοντας	ð i n̪ o d̪ ɐ s 
δασκάλου	ð ɐ s k ɐ l u 
δείπνησα	ð i p n̪ i s ɐ 
δεδομένα	ð ɛ ð o m ɛ n̪ ɐ 
δεμένους	ð ɛ m ɛ n̪ u s 
δεύτερου	ð ɛ f t̪ ɛ ɾ u 
διάβαινε	ð i ɐ v ɛ n̪ ɛ 
διάβασμα	ð i ɐ v ɐ s m ɐ 
διάβολος	ð i ɐ v o l o s 
διάδρομο	ð i ɐ ð ɾ o m o 
διάθεσης	ð i ɐ θ ɛ s i s 
διάφανες	ð i ɐ f ɐ n̪ ɛ s 
διέκοψαν	ð i ɛ k o p s ɐ n̪ 
διαβάζει	ð i ɐ v ɐ z i 
διαβάσει	ð i ɐ v ɐ s i 
διαβόλου	ð i ɐ v o l u 
διακρίνω	ð i ɐ k ɾ i n̪ o 
διαλέξει	ð i ɐ l ɛ k s i 
διατάζει	ð i ɐ t̪ ɐ z i 
διαταγές	ð i ɐ t̪ ɐ ɣ ɛ s 
διεύθυνα	ð i ɛ f θ i n̪ ɐ 
δικαίωμα	ð i k ɛ o m ɐ 
δικαστές	ð i k ɐ s t̪ ɛ s 
δικαστής	ð i k ɐ s t̪ i s 
διοίκηση	ð i k i s i 
δισταγμό	ð i s t̪ ɐ ɣ m o 
διόρθωσα	ð i o ɾ θ o s ɐ 
διώξουμε	ð i o k s u m ɛ 
δοκίμασε	ð o k i m ɐ s ɛ 
δοκιμάσω	ð o k i m ɐ s o 
δουλέψει	ð u l ɛ p s i 
δουλειές	ð u l i ɛ s 
δουλεύει	ð u l ɛ v i 
δούλευαν	ð u l ɛ v ɐ n̪ 
δούλεψαν	ð u l ɛ p s ɐ n̪ 
δυσκολία	ð i s k o l i ɐ 
δυστυχία	ð i s t̪ i x i ɐ 
δωματίων	ð o m ɐ t̪ i o n̪ 
εβδομάδα	ɛ v ð o m ɐ ð ɐ 
εγύρισες	ɛ ɣ i ɾ i s ɛ s 
ειδήσεις	i ð i s i s 
ειρωνεία	i ɾ o n̪ i ɐ 
ειρωνικά	i ɾ o n̪ i k ɐ 
εκδήλωση	ɛ k ð i l o s i 
εκείνους	ɛ k i n̪ u s 
εκτελέσω	ɛ k t̪ ɛ l ɛ s o 
ελάχιστη	ɛ l ɐ x i s t̪ i 
ελαιώνες	ɛ l ɛ o n̪ ɛ s 
ελληνική	ɛ l i n̪ i k i 
ελπίζεις	ɛ l p i z i s 
εμπόδιζα	ɛ b o ð i z ɐ 
εναντίον	ɛ n̪ ɐ d̪ i o n̪ 
εννοήσει	ɛ n̪ n̪ o i s i 
εννοούσε	ɛ n̪ n̪ o u s ɛ 
εντατική	ɛ d̪ ɐ t̪ i k i 
εντύπωση	ɛ d̪ i p o s i 
ενωμένες	ɛ n̪ o m ɛ n̪ ɛ s 
ενωμένοι	ɛ n̪ o m ɛ n̪ i 
ενωτικές	ɛ n̪ o t̪ i k ɛ s 
εξάδελφο	ɛ k s ɐ ð ɛ l f o 
εξετάζει	ɛ k s ɛ t̪ ɐ z i 
εξηγήσει	ɛ k s i ɣ i s i 
εξώπορτα	ɛ k s o p o ɾ t̪ ɐ 
εξώφυλλο	ɛ k s o f i l o 
επέλεγες	ɛ p ɛ l ɛ ɣ ɛ s 
επέμεινε	ɛ p ɛ m i n̪ ɛ 
επίδραση	ɛ p i ð ɾ ɐ s i 
επίτευξη	ɛ p i t̪ ɛ f k s i 
επίτηδες	ɛ p i t̪ i ð ɛ s 
επιβλαβή	ɛ p i v l ɐ v i 
επιγραφή	ɛ p i ɣ ɾ ɐ f i 
επιδίωξη	ɛ p i ð i o k s i 
επιλογές	ɛ p i l o ɣ ɛ s 
επλήρωνε	ɛ p l i ɾ o n̪ ɛ 
επόμενου	ɛ p o m ɛ n̪ u 
εργαλεία	ɛ ɾ ɣ ɐ l i ɐ 
εργαλείο	ɛ ɾ ɣ ɐ l i o 
ερχόμουν	ɛ ɾ x o m u n̪ 
εταιρεία	ɛ t̪ ɛ ɾ i ɐ 
ετοίμαζε	ɛ t̪ i m ɐ z ɛ 
ευγένεια	ɛ v ɣ ɛ n̪ i ɐ 
ευκαιρία	ɛ f k ɛ ɾ i ɐ 
ευλόγησε	ɛ v l o ɣ i s ɛ 
εφιάλτες	ɛ f i ɐ l t̪ ɛ s 
ζαλίζεις	z ɐ l i z i s 
ζαρωμένα	z ɐ ɾ o m ɛ n̪ ɐ 
ζελατίνα	z ɛ l ɐ t̪ i n̪ ɐ 
ζεύθηκαν	z ɛ f θ i k ɐ n̪ 
ζημιώσει	z i m i o s i 
ζητήσεις	z i t̪ i s i s 
ζητήσουν	z i t̪ i s u n̪ 
ζητιάνοι	z i t̪ i ɐ n̪ i 
ζητιάνος	z i t̪ i ɐ n̪ o s 
ηρεμήσει	i ɾ ɛ m i s i 
ηρωισμός	i ɾ o i s m o s 
θέλοντας	θ ɛ l o d̪ ɐ s 
θαυμασμό	θ ɐ v m ɐ s m o 
θελήσεις	θ ɛ l i s i s 
θησαυρού	θ i s ɐ v ɾ u 
θησαυρός	θ i s ɐ v ɾ o s 
θρεπτικό	θ ɾ ɛ p t̪ i k o 
θυμήθηκα	θ i m i θ i k ɐ 
θυμήθηκε	θ i m i θ i k ɛ 
θυμίζεις	θ i m i z i s 
θυμίζουν	θ i m i z u n̪ 
θυμηθείς	θ i m i θ i s 
θυμούμαι	θ i m u m ɛ 
θυμωμένα	θ i m o m ɛ n̪ ɐ 
θυμωμένη	θ i m o m ɛ n̪ i 
ιστορίες	i s t̪ o ɾ i ɛ s 
κάθονται	k ɐ θ o d̪ ɛ 
κάθονταν	k ɐ θ o d̪ ɐ n̪ 
κάμποσες	k ɐ b o s ɛ s 
κάτασπρα	k ɐ t̪ ɐ s p ɾ ɐ 
κάτασπρο	k ɐ t̪ ɐ s p ɾ o 
κάτοικοι	k ɐ t̪ i k i 
κίνδυνος	k i n̪ ð i n̪ o s 
καβαλάρη	k ɐ v ɐ l ɐ ɾ i 
καβγάδες	k ɐ v ɣ ɐ ð ɛ s 
καθίσαμε	k ɐ θ i s ɐ m ɛ 
καθίσατε	k ɐ θ i s ɐ t̪ ɛ 
καθίσομε	k ɐ θ i s o m ɛ 
καθίσουν	k ɐ θ i s u n̪ 
καθαρίσω	k ɐ θ ɐ ɾ i s o 
καθιστός	k ɐ θ i s t̪ o s 
καθρέφτη	k ɐ θ ɾ ɛ f t̪ i 
καιγόταν	k ɛ ɣ o t̪ ɐ n̪ 
καλαθάκι	k ɐ l ɐ θ ɐ k i 
καλοσύνη	k ɐ l o s i n̪ i 
καλύτερά	k ɐ l i t̪ ɛ ɾ ɐ 
καλύτερα	k ɐ l i t̪ ɛ ɾ ɐ 
καλύτερη	k ɐ l i t̪ ɛ ɾ i 
καλύτερο	k ɐ l i t̪ ɛ ɾ o 
καμαράκι	k ɐ m ɐ ɾ ɐ k i 
καμπούρα	k ɐ b u ɾ ɐ 
καμτσίκι	k ɐ m t̪ s i k i 
καμώματα	k ɐ m o m ɐ t̪ ɐ 
κανονίσω	k ɐ n̪ o n̪ i s o 
κανονικό	k ɐ n̪ o n̪ i k o 
καραβιού	k ɐ ɾ ɐ v i u 
καραβιών	k ɐ ɾ ɐ v i o n̪ 
καρκίνος	k ɐ ɾ k i n̪ o s 
κατάλαβα	k ɐ t̪ ɐ l ɐ v ɐ 
κατάλαβε	k ɐ t̪ ɐ l ɐ v ɛ 
κατάματα	k ɐ t̪ ɐ m ɐ t̪ ɐ 
κατάντια	k ɐ t̪ ɐ d̪ i ɐ 
κατάξερο	k ɐ t̪ ɐ k s ɛ ɾ o 
κατάφερε	k ɐ t̪ ɐ f ɛ ɾ ɛ 
κατάφυτη	k ɐ t̪ ɐ f i t̪ i 
κατέβαζε	k ɐ t̪ ɛ v ɐ z ɛ 
κατέβασα	k ɐ t̪ ɛ v ɐ s ɐ 
κατέβασε	k ɐ t̪ ɛ v ɐ s ɛ 
κατέβηκα	k ɐ t̪ ɛ v i k ɐ 
κατέβηκε	k ɐ t̪ ɛ v i k ɛ 
καταγίνω	k ɐ t̪ ɐ ɣ i n̪ o 
καταδίκη	k ɐ t̪ ɐ ð i k i 
καταφέρω	k ɐ t̪ ɐ f ɛ ɾ o 
κατεβάζω	k ɐ t̪ ɛ v ɐ z o 
κατσίκες	k ɐ t̪ s i k ɛ s 
κελαριού	k ɛ l ɐ ɾ i u 
κεραμιδί	k ɛ ɾ ɐ m i ð i 
κεφαλιού	k ɛ f ɐ l i u 
κηπαράκι	k i p ɐ ɾ ɐ k i 
κινδύνου	k i n̪ ð i n̪ u 
κλαύθηκε	k l ɐ f θ i k ɛ 
κλείδωσε	k l i ð o s ɛ 
κλείσουν	k l i s u n̪ 
κλειδάκι	k l i ð ɐ k i 
κλεμμένα	k l ɛ m ɛ n̪ ɐ 
κλεμμένο	k l ɛ m ɛ n̪ o 
κλωνάρια	k l o n̪ ɐ ɾ i ɐ 
κλώτσησε	k l o t̪ s i s ɛ 
κοίταζαν	k i t̪ ɐ z ɐ n̪ 
κοίταξαν	k i t̪ ɐ k s ɐ n̪ 
κοιμάται	k i m ɐ t̪ ɛ 
κοιμήσου	k i m i s u 
κοιμηθεί	k i m i θ i 
κοιτάζει	k i t̪ ɐ z i 
κοιτάξει	k i t̪ ɐ k s i 
κομμάτια	k o m ɐ t̪ i ɐ 
κομμένες	k o m ɛ n̪ ɛ s 
κοντάρια	k o d̪ ɐ ɾ i ɐ 
κορδέλες	k o ɾ ð ɛ l ɛ s 
κορδόνια	k o ɾ ð o n̪ i ɐ 
κουβέντα	k u v ɛ d̪ ɐ 
κουβέρτα	k u v ɛ ɾ t̪ ɐ 
κουδούνι	k u ð u n̪ i 
κουζίνας	k u z i n̪ ɐ s 
κουκκίδα	k u k i ð ɐ 
κουνέλια	k u n̪ ɛ l i ɐ 
κουνήσει	k u n̪ i s i 
κουπάκια	k u p ɐ k i ɐ 
κουράγιο	k u ɾ ɐ ɣ i o 
κουράσει	k u ɾ ɐ s i 
κουτεντέ	k u t̪ ɛ d̪ ɛ 
κράτησες	k ɾ ɐ t̪ i s ɛ s 
κρατικού	k ɾ ɐ t̪ i k u 
κρατούσε	k ɾ ɐ t̪ u s ɛ 
κρεμάσει	k ɾ ɛ m ɐ s i 
κρεμαστά	k ɾ ɛ m ɐ s t̪ ɐ 
κρεμαστή	k ɾ ɛ m ɐ s t̪ i 
κρυμμένα	k ɾ i m ɛ n̪ ɐ 
κρυμμένη	k ɾ i m ɛ n̪ i 
κρυμμένο	k ɾ i m ɛ n̪ o 
κρύβεσαι	k ɾ i v ɛ s ɛ 
κρύβεται	k ɾ i v ɛ t̪ ɛ 
κυβερνάς	k i v ɛ ɾ n̪ ɐ s 
κυλούσαν	k i l u s ɐ n̪ 
κυλώντας	k i l o d̪ ɐ s 
κυνήγησε	k i n̪ i ɣ i s ɛ 
κυνηγάει	k i n̪ i ɣ ɐ i 
κυνηγητό	k i n̪ i ɣ i t̪ o 
κόκκινος	k o k i n̪ o s 
κότσυφας	k o t̪ s i f ɐ s 
λαχανικά	l ɐ x ɐ n̪ i k ɐ 
λιγότερο	l i ɣ o t̪ ɛ ɾ o 
λουλούδι	l u l u ð i 
λυπήθηκε	l i p i θ i k ɛ 
λυπημένα	l i p i m ɛ n̪ ɐ 
λυπημένη	l i p i m ɛ n̪ i 
μάγειρας	m ɐ ɣ i ɾ ɐ s 
μάγειροι	m ɐ ɣ i ɾ i 
μάρτυρας	m ɐ ɾ t̪ i ɾ ɐ s 
μέλισσες	m ɛ l i s ɛ s 
μαγαζιού	m ɐ ɣ ɐ z i u 
μαγειριό	m ɐ ɣ i ɾ i o 
μαζέψομε	m ɐ z ɛ p s o m ɛ 
μαζέψουν	m ɐ z ɛ p s u n̪ 
μαζεμένη	m ɐ z ɛ m ɛ n̪ i 
μαζευθεί	m ɐ z ɛ f θ i 
μαζεύεις	m ɐ z ɛ v i s 
μαθαίνει	m ɐ θ ɛ n̪ i 
μαλώματα	m ɐ l o m ɐ t̪ ɐ 
μαμούνια	m ɐ m u n̪ i ɐ 
μαντίλια	m ɐ d̪ i l i ɐ 
μαραγκοί	m ɐ ɾ ɐ ɡ i 
μαραμένο	m ɐ ɾ ɐ m ɛ n̪ o 
μαρούλια	m ɐ ɾ u l i ɐ 
μασχάλες	m ɐ s x ɐ l ɛ s 
μείνουμε	m i n̪ u m ɛ 
μεγαλείο	m ɛ ɣ ɐ l i o 
μειλίχιο	m i l i x i o 
μελέτησε	m ɛ l ɛ t̪ i s ɛ 
μελίσσια	m ɛ l i s i ɐ 
μελόπιτα	m ɛ l o p i t̪ ɐ 
μερικούς	m ɛ ɾ i k u s 
μερμήγκι	m ɛ ɾ m i ɡ i 
μεσημέρι	m ɛ s i m ɛ ɾ i 
μεταξωτά	m ɛ t̪ ɐ k s o t̪ ɐ 
μεταξωτό	m ɛ t̪ ɐ k s o t̪ o 
μεταφορά	m ɛ t̪ ɐ f o ɾ ɐ 
μηχάνημα	m i x ɐ n̪ i m ɐ 
μικρούλα	m i k ɾ u l ɐ 
μιλήσεις	m i l i s i s 
μιλήσουν	m i l i s u n̪ 
μιλούσαν	m i l u s ɐ n̪ 
μιλώντας	m i l o d̪ ɐ s 
μοναδικό	m o n̪ ɐ ð i k o 
μοναχική	m o n̪ ɐ x i k i 
μοναχικό	m o n̪ ɐ x i k o 
μονότονα	m o n̪ o t̪ o n̪ ɐ 
μουλάρια	m u l ɐ ɾ i ɐ 
μπάτσους	b ɐ t̪ s u s 
μπήχθηκε	b i x θ i k ɛ 
μπαίνετε	b ɛ n̪ ɛ t̪ ɛ 
μπαλάσκα	b ɐ l ɐ s k ɐ 
μπορείτε	b o ɾ i t̪ ɛ 
μπορούμε	b o ɾ u m ɛ 
μπορούσα	b o ɾ u s ɐ 
μπορούσε	b o ɾ u s ɛ 
μποτίλια	b o t̪ i l i ɐ 
μυρωδάτα	m i ɾ o ð ɐ t̪ ɐ 
ναύαρχος	n̪ ɐ v ɐ ɾ x o s 
νεαρούλα	n̪ ɛ ɐ ɾ u l ɐ 
νηστείας	n̪ i s t̪ i ɐ s 
νομίζεις	n̪ o m i z i s 
νοσοκόμο	n̪ o s o k o m o 
ντουλάπι	d̪ u l ɐ p i 
νυχτώσει	n̪ i x t̪ o s i 
νωρίτερα	n̪ o ɾ i t̪ ɛ ɾ ɐ 
νόστιμος	n̪ o s t̪ i m o s 
ξάπλωσαν	k s ɐ p l o s ɐ n̪ 
ξέπλεναν	k s ɛ p l ɛ n̪ ɐ n̪ 
ξέσπασαν	k s ɛ s p ɐ s ɐ n̪ 
ξέσχισμα	k s ɛ s x i s m ɐ 
ξαμαρτία	k s ɐ m ɐ ɾ t̪ i ɐ 
ξανάδεσε	k s ɐ n̪ ɐ ð ɛ s ɛ 
ξανάπεσε	k s ɐ n̪ ɐ p ɛ s ɛ 
ξαναβρεί	k s ɐ n̪ ɐ v ɾ i 
ξαναδώσω	k s ɐ n̪ ɐ ð o s o 
ξαναπήρε	k s ɐ n̪ ɐ p i ɾ ɛ 
ξαπλωθεί	k s ɐ p l o θ i 
ξεκίνησε	k s ɛ k i n̪ i s ɛ 
ξεκινούν	k s ɛ k i n̪ u n̪ 
ξεμάθετε	k s ɛ m ɐ θ ɛ t̪ ɛ 
ξεπλυθεί	k s ɛ p l i θ i 
ξεφωνητά	k s ɛ f o n̪ i t̪ ɐ 
ξεφώνιζε	k s ɛ f o n̪ i z ɛ 
ξεφώνισε	k s ɛ f o n̪ i s ɛ 
ξεχάσεις	k s ɛ x ɐ s i s 
ξεχάσομε	k s ɛ x ɐ s o m ɛ 
ξεχώριζε	k s ɛ x o ɾ i z ɛ 
ξεχώρισε	k s ɛ x o ɾ i s ɛ 
ξεψύχησε	k s ɛ p s i x i s ɛ 
ξυπνήσει	k s i p n̪ i s i 
ξυπνούσε	k s i p n̪ u s ɛ 
ξύπνησαν	k s i p n̪ i s ɐ n̪ 
ξύπνησες	k s i p n̪ i s ɛ s 
οδήγησαν	o ð i ɣ i s ɐ n̪ 
οδηγήσει	o ð i ɣ i s i 
οδηγούσε	o ð i ɣ u s ɛ 
ολόκληρη	o l o k l i ɾ i 
ολόκληρο	o l o k l i ɾ o 
ομορφιές	o m o ɾ f i ɛ s 
ονείρατά	o n̪ i ɾ ɐ t̪ ɐ 
οπλίσεις	o p l i s i s 
οπλίσομε	o p l i s o m ɛ 
ορίζοντα	o ɾ i z o d̪ ɐ 
ορεκτικό	o ɾ ɛ k t̪ i k o 
πήγαιναν	p i ɣ ɛ n̪ ɐ n̪ 
πήγαινες	p i ɣ ɛ n̪ ɛ s 
πίστευαν	p i s t̪ ɛ v ɐ n̪ 
παίξουμε	p ɛ k s u m ɛ 
παίρναμε	p ɛ ɾ n̪ ɐ m ɛ 
παίρνεις	p ɛ ɾ n̪ i s 
παίρνουν	p ɛ ɾ n̪ u n̪ 
παγωμένη	p ɐ ɣ o m ɛ n̪ i 
παιδούλα	p ɛ ð u l ɐ 
παιχνίδι	p ɛ x n̪ i ð i 
παλέψουν	p ɐ l ɛ p s u n̪ 
παλατάκι	p ɐ l ɐ t̪ ɐ k i 
παλατιού	p ɐ l ɐ t̪ i u 
παλικάρι	p ɐ l i k ɐ ɾ i 
πανεριού	p ɐ n̪ ɛ ɾ i u 
πανηγύρι	p ɐ n̪ i ɣ i ɾ i 
πανωφόρι	p ɐ n̪ o f o ɾ i 
παπούτσι	p ɐ p u t̪ s i 
παράθυρα	p ɐ ɾ ɐ θ i ɾ ɐ 
παράθυρο	p ɐ ɾ ɐ θ i ɾ o 
παράμερα	p ɐ ɾ ɐ m ɛ ɾ ɐ 
παράνομη	p ɐ ɾ ɐ n̪ o m i 
παράξενα	p ɐ ɾ ɐ k s ɛ n̪ ɐ 
παράξενο	p ɐ ɾ ɐ k s ɛ n̪ o 
παράπονα	p ɐ ɾ ɐ p o n̪ ɐ 
παράπονο	p ɐ ɾ ɐ p o n̪ o 
παράσημο	p ɐ ɾ ɐ s i m o 
παράτησα	p ɐ ɾ ɐ t̪ i s ɐ 
παράτησε	p ɐ ɾ ɐ t̪ i s ɛ 
παρέδωσε	p ɐ ɾ ɛ ð o s ɛ 
παρέσυρε	p ɐ ɾ ɛ s i ɾ ɛ 
παραγιοί	p ɐ ɾ ɐ ɣ i 
παραγιός	p ɐ ɾ ɐ ɣ i o s 
παρακάτω	p ɐ ɾ ɐ k ɐ t̪ o 
παρακαλώ	p ɐ ɾ ɐ k ɐ l o 
παρακόρη	p ɐ ɾ ɐ k o ɾ i 
παραμονή	p ɐ ɾ ɐ m o n̪ i 
παραπάνω	p ɐ ɾ ɐ p ɐ n̪ o 
παρελθόν	p ɐ ɾ ɛ l θ o n̪ 
παρουσία	p ɐ ɾ u s i ɐ 
παρούσας	p ɐ ɾ u s ɐ s 
παρόμοια	p ɐ ɾ o m i ɐ 
παρόντες	p ɐ ɾ o d̪ ɛ s 
πατήτρες	p ɐ t̪ i t̪ ɾ ɛ s 
πατριώτη	p ɐ t̪ ɾ i o t̪ i 
πείσματα	p i s m ɐ t̪ ɐ 
πεδιάδας	p ɛ ð i ɐ ð ɐ s 
πεθάνεις	p ɛ θ ɐ n̪ i s 
πεθαμένο	p ɛ θ ɐ m ɛ n̪ o 
πεινάσει	p i n̪ ɐ s i 
πεινούσε	p i n̪ u s ɛ 
πειράζει	p i ɾ ɐ z i 
περάσαμε	p ɛ ɾ ɐ s ɐ m ɛ 
περάσεις	p ɛ ɾ ɐ s i s 
περάσομε	p ɛ ɾ ɐ s o m ɛ 
περάσουν	p ɛ ɾ ɐ s u n̪ 
περήφανα	p ɛ ɾ i f ɐ n̪ ɐ 
περίεργα	p ɛ ɾ i ɛ ɾ ɣ ɐ 
περίεργη	p ɛ ɾ i ɛ ɾ ɣ i 
περίεργο	p ɛ ɾ i ɛ ɾ ɣ o 
περίλυπη	p ɛ ɾ i l i p i 
περίμενα	p ɛ ɾ i m ɛ n̪ ɐ 
περίμενε	p ɛ ɾ i m ɛ n̪ ɛ 
περίπατο	p ɛ ɾ i p ɐ t̪ o 
περίφημα	p ɛ ɾ i f i m ɐ 
περιβόλι	p ɛ ɾ i v o l i 
περιμένω	p ɛ ɾ i m ɛ n̪ o 
περνούσα	p ɛ ɾ n̪ u s ɐ 
περνούσε	p ɛ ɾ n̪ u s ɛ 
πεσμένες	p ɛ s m ɛ n̪ ɛ s 
πεσμένοι	p ɛ s m ɛ n̪ i 
πεσμένος	p ɛ s m ɛ n̪ o s 
πεταμένα	p ɛ t̪ ɐ m ɛ n̪ ɐ 
πετούσαν	p ɛ t̪ u s ɐ n̪ 
πετράδια	p ɛ t̪ ɾ ɐ ð i ɐ 
πηλαλητό	p i l ɐ l i t̪ o 
πιάστηκε	p i ɐ s t̪ i k ɛ 
πιωμένοι	p i o m ɛ n̪ i 
πλάτανου	p l ɐ t̪ ɐ n̪ u 
πλακώσει	p l ɐ k o s i 
πλαστικό	p l ɐ s t̪ i k o 
πλατείας	p l ɐ t̪ i ɐ s 
πληθαίνω	p l i θ ɛ n̪ o 
πληρώνει	p l i ɾ o n̪ i 
πληρώσει	p l i ɾ o s i 
πλησίαζε	p l i s i ɐ z ɛ 
πλησίασε	p l i s i ɐ s ɛ 
πλούσιοι	p l u s i 
πνιγμένη	p n̪ i ɣ m ɛ n̪ i 
ποδήματα	p o ð i m ɐ t̪ ɐ 
ποικιλία	p i k i l i ɐ 
ποκάμισο	p o k ɐ m i s o 
πολεμάνε	p o l ɛ m ɐ n̪ ɛ 
πολύτιμα	p o l i t̪ i m ɐ 
πολύτιμη	p o l i t̪ i m i 
πολύτιμο	p o l i t̪ i m o 
ποντίκια	p o d̪ i k i ɐ 
πουλάκια	p u l ɐ k i ɐ 
πουλήσει	p u l i s i 
πουληθεί	p u l i θ i 
πούλησες	p u l i s ɛ s 
πούπουλο	p u p u l o 
πράγματά	p ɾ ɐ ɣ m ɐ t̪ ɐ 
πράγματα	p ɾ ɐ ɣ m ɐ t̪ ɐ 
πράσινες	p ɾ ɐ s i n̪ ɛ s 
πρακτική	p ɾ ɐ k t̪ i k i 
πρησμένα	p ɾ i s m ɛ n̪ ɐ 
προδότης	p ɾ o ð o t̪ i s 
προδώσει	p ɾ o ð o s i 
προκόβει	p ɾ o k o v i 
προλάβει	p ɾ o l ɐ v i 
προσέξει	p ɾ o s ɛ k s i 
προσέχει	p ɾ o s ɛ x i 
προσβολή	p ɾ o s v o l i 
προσευχή	p ɾ o s ɛ f x i 
προστάτη	p ɾ o s t̪ ɐ t̪ i 
προσταγή	p ɾ o s t̪ ɐ ɣ i 
προσφορά	p ɾ o s f o ɾ ɐ 
προσώπου	p ɾ o s o p u 
προσώπων	p ɾ o s o p o n̪ 
προτείνω	p ɾ o t̪ i n̪ o 
προφθάσω	p ɾ o f θ ɐ s o 
προχωρεί	p ɾ o x o ɾ i 
προϊόντα	p ɾ o i o d̪ ɐ 
πρόκληση	p ɾ o k l i s i 
πρόκοβαν	p ɾ o k o v ɐ n̪ 
πρόσθεσε	p ɾ o s θ ɛ s ɛ 
πρόσταξε	p ɾ o s t̪ ɐ k s ɛ 
πρόστυχη	p ɾ o s t̪ i x i 
πρόσφατα	p ɾ o s f ɐ t̪ ɐ 
πρόσφερε	p ɾ o s f ɛ ɾ ɛ 
πρότασής	p ɾ o t̪ ɐ s i s 
πρότασης	p ɾ o t̪ ɐ s i s 
πρότεινε	p ɾ o t̪ i n̪ ɛ 
πρόφθασα	p ɾ o f θ ɐ s ɐ 
πρόφθασε	p ɾ o f θ ɐ s ɛ 
πρόχειρη	p ɾ o x i ɾ i 
πυρκαγιά	p i ɾ k ɐ ɣ i ɐ 
πυρωμένα	p i ɾ o m ɛ n̪ ɐ 
πυρωμένο	p i ɾ o m ɛ n̪ o 
ρίχθηκαν	ɾ i x θ i k ɐ n̪ 
ρίχνεσαι	ɾ i x n̪ ɛ s ɛ 
ρεσεψιόν	ɾ ɛ s ɛ p s i o n̪ 
ρημάξανε	ɾ i m ɐ k s ɐ n̪ ɛ 
ροκανίδι	ɾ o k ɐ n̪ i ð i 
ρωτήματα	ɾ o t̪ i m ɐ t̪ ɐ 
ρωτήσομε	ɾ o t̪ i s o m ɛ 
ρωτήσουν	ɾ o t̪ i s u n̪ 
ρωτούσες	ɾ o t̪ u s ɛ s 
ρωτώντας	ɾ o t̪ o d̪ ɐ s 
σάλπιγγα	s ɐ l p i ɡ ɐ 
σίγουρος	s i ɣ u ɾ o s 
σακούλες	s ɐ k u l ɛ s 
σαπίζουν	s ɐ p i z u n̪ 
σαράβαλα	s ɐ ɾ ɐ v ɐ l ɐ 
σαστίζει	s ɐ s t̪ i z i 
σβησμένη	s v i s m ɛ n̪ i 
σεβαστού	s ɛ v ɐ s t̪ u 
σεντούκι	s ɛ d̪ u k i 
σηκωθούν	s i k o θ u n̪ 
σηκώθηκε	s i k o θ i k ɛ 
σηκώσαμε	s i k o s ɐ m ɛ 
σημάδεψε	s i m ɐ ð ɛ p s ɛ 
σημαίνει	s i m ɛ n̪ i 
σημασίας	s i m ɐ s i ɐ s 
σηματάκι	s i m ɐ t̪ ɐ k i 
σιμώσουν	s i m o s u n̪ 
σκέπαζαν	s k ɛ p ɐ z ɐ n̪ 
σκέπασμα	s k ɛ p ɐ s m ɐ 
σκέφθηκε	s k ɛ f θ i k ɛ 
σκέφτηκε	s k ɛ f t̪ i k ɛ 
σκαλίτσα	s k ɐ l i t̪ s ɐ 
σκαλώσει	s k ɐ l o s i 
σκονάκια	s k o n̪ ɐ k i ɐ 
σκοτεινά	s k o t̪ i n̪ ɐ 
σκοτωθεί	s k o t̪ o θ i 
σκοτώσει	s k o t̪ o s i 
σκούπιζε	s k u p i z ɛ 
σκούπισε	s k u p i s ɛ 
σκυμμένα	s k i m ɛ n̪ ɐ 
σκυμμένο	s k i m ɛ n̪ o 
σκότισες	s k o t̪ i s ɛ s 
σμεουριά	s m ɛ u ɾ i ɐ 
σούβλισε	s u v l i s ɛ 
σούφρωσε	s u f ɾ o s ɛ 
σπάγκους	s p ɐ ɡ u s 
σπάτουλα	s p ɐ t̪ u l ɐ 
σπαρμένα	s p ɐ ɾ m ɛ n̪ ɐ 
σπασμένα	s p ɐ s m ɛ n̪ ɐ 
σπασμένη	s p ɐ s m ɛ n̪ i 
σπασμένο	s p ɐ s m ɛ n̪ o 
σπείρομε	s p i ɾ o m ɛ 
σπρωξιές	s p ɾ o k s i ɛ s 
σπρώχνει	s p ɾ o x n̪ i 
στέγνωσε	s t̪ ɛ ɣ n̪ o s ɛ 
στέκεσαι	s t̪ ɛ k ɛ s ɛ 
στέλναμε	s t̪ ɛ l n̪ ɐ m ɛ 
στένευαν	s t̪ ɛ n̪ ɛ v ɐ n̪ 
στέφθηκε	s t̪ ɛ f θ i k ɛ 
σταφύλια	s t̪ ɐ f i l i ɐ 
στείλεις	s t̪ i l i s 
στερέωσε	s t̪ ɛ ɾ ɛ o s ɛ 
στολίζει	s t̪ o l i z i 
στραβούς	s t̪ ɾ ɐ v u s 
στρατηγό	s t̪ ɾ ɐ t̪ i ɣ o 
στρωμένο	s t̪ ɾ o m ɛ n̪ o 
στόλαρχο	s t̪ o l ɐ ɾ x o 
συγγενών	s i ɡ ɛ n̪ o n̪ 
συγύριζε	s i ɣ i ɾ i z ɛ 
συγύρισα	s i ɣ i ɾ i s ɐ 
συζήτηση	s i z i t̪ i s i 
συζητήσω	s i z i t̪ i s o 
συλλαβές	s i l ɐ v ɛ s 
συμβουλή	s i m v u l i 
συμφέρει	s i m f ɛ ɾ i 
συμφέρον	s i m f ɛ ɾ o n̪ 
συμφωνία	s i m f o n̪ i ɐ 
συνέβηκε	s i n̪ ɛ v i k ɛ 
συνέχισε	s i n̪ ɛ x i s ɛ 
συνήθιζε	s i n̪ i θ i z ɛ 
συνεφέρω	s i n̪ ɛ f ɛ ɾ o 
συνθήκες	s i n̪ θ i k ɛ s 
συντομία	s i d̪ o m i ɐ 
συρτάρια	s i ɾ t̪ ɐ ɾ i ɐ 
σφίχθηκε	s f i x θ i k ɛ 
σφενδόνα	s f ɛ n̪ ð o n̪ ɐ 
σφιγμένα	s f i ɣ m ɛ n̪ ɐ 
σφύριγμα	s f i ɾ i ɣ m ɐ 
σχισμένα	s x i s m ɛ n̪ ɐ 
σχισμένη	s x i s m ɛ n̪ i 
σχισμένο	s x i s m ɛ n̪ o 
σχολείου	s x o l i u 
σχολείων	s x o l i o n̪ 
σωματική	s o m ɐ t̪ i k i 
σωπάσεις	s o p ɐ s i s 
σύμμαχος	s i m ɐ x o s 
σύμφωνος	s i m f o n̪ o s 
σύνδεσμο	s i n̪ ð ɛ s m o 
τέντζερέ	t̪ ɛ d̪ z ɛ ɾ ɛ 
τέσσερις	t̪ ɛ s ɛ ɾ i s 
τέτοιους	t̪ ɛ t̪ i u s 
ταβέρνας	t̪ ɐ v ɛ ɾ n̪ ɐ s 
ταβέρνες	t̪ ɐ v ɛ ɾ n̪ ɛ s 
ταπεινοί	t̪ ɐ p i n̪ i 
ταραχθεί	t̪ ɐ ɾ ɐ x θ i 
τελείωσε	t̪ ɛ l i o s ɛ 
τελειώσω	t̪ ɛ l i o s o 
τεντώνει	t̪ ɛ d̪ o n̪ i 
τεσσάρων	t̪ ɛ s ɐ ɾ o n̪ 
τεσσερις	t̪ ɛ s ɛ ɾ i s 
τεχνίτες	t̪ ɛ x n̪ i t̪ ɛ s 
τεχνητής	t̪ ɛ x n̪ i t̪ i s 
τηλέφωνα	t̪ i l ɛ f o n̪ ɐ 
τηλέφωνο	t̪ i l ɛ f o n̪ o 
τηλέφωνό	t̪ i l ɛ f o n̪ o 
τιμημένη	t̪ i m i m ɛ n̪ i 
τολμήσει	t̪ o l m i s i 
τράβηξαν	t̪ ɾ ɐ v i k s ɐ n̪ 
τράνταξε	t̪ ɾ ɐ d̪ ɐ k s ɛ 
τραβήξει	t̪ ɾ ɐ v i k s i 
τραβούμε	t̪ ɾ ɐ v u m ɛ 
τραβούσα	t̪ ɾ ɐ v u s ɐ 
τραγουδώ	t̪ ɾ ɐ ɣ u ð o 
τραγούδι	t̪ ɾ ɐ ɣ u ð i 
τραπέζια	t̪ ɾ ɐ p ɛ z i ɐ 
τραχηλιά	t̪ ɾ ɐ x i l i ɐ 
τρεχάτος	t̪ ɾ ɛ x ɐ t̪ o s 
τροφαντά	t̪ ɾ o f ɐ d̪ ɐ 
τροφαντό	t̪ ɾ o f ɐ d̪ o 
τρόμαξαν	t̪ ɾ o m ɐ k s ɐ n̪ 
τρύπησαν	t̪ ɾ i p i s ɐ n̪ 
τσεκούρι	t̪ s ɛ k u ɾ i 
τσιμπίδα	t̪ s i b i ð ɐ 
τσιμπούν	t̪ s i b u n̪ 
τσιριχτό	t̪ s i ɾ i x t̪ o 
υιοθετεί	i o θ ɛ t̪ i 
υλοτομία	i l o t̪ o m i ɐ 
υπάρχουν	i p ɐ ɾ x u n̪ 
υπέρτατο	i p ɛ ɾ t̪ ɐ t̪ o 
υπηρέτες	i p i ɾ ɛ t̪ ɛ s 
υπηρεσία	i p i ɾ ɛ s i ɐ 
υπογραφή	i p o ɣ ɾ ɐ f i 
υποδοχής	i p o ð o x i s 
υπόκλιση	i p o k l i s i 
υφάσματα	i f ɐ s m ɐ t̪ ɐ 
υφασμένο	i f ɐ s m ɛ n̪ o 
φαίνεσαι	f ɛ n̪ ɛ s ɛ 
φαίνεται	f ɛ n̪ ɛ t̪ ɛ 
φαγωθούν	f ɐ ɣ o θ u n̪ 
φαινόταν	f ɛ n̪ o t̪ ɐ n̪ 
φαμελική	f ɐ m ɛ l i k i 
φαναριού	f ɐ n̪ ɐ ɾ i u 
φελούκας	f ɛ l u k ɐ s 
φελούκες	f ɛ l u k ɛ s 
φευγαλέο	f ɛ v ɣ ɐ l ɛ o 
φλαμούρι	f l ɐ m u ɾ i 
φοβέρισε	f o v ɛ ɾ i s ɛ 
φοβήθηκε	f o v i θ i k ɛ 
φοβηθείς	f o v i θ i s 
φονιάδες	f o n̪ i ɐ ð ɛ s 
φορέματα	f o ɾ ɛ m ɐ t̪ ɐ 
φορεσιές	f o ɾ ɛ s i ɛ s 
φουρνέλο	f u ɾ n̪ ɛ l o 
φούντωνε	f u d̪ o n̪ ɛ 
φούσκωνε	f u s k o n̪ ɛ 
φράουλες	f ɾ ɐ u l ɛ s 
φρένιασε	f ɾ ɛ n̪ i ɐ s ɛ 
φραουλιά	f ɾ ɐ u l i ɐ 
φροντίδα	f ɾ o d̪ i ð ɐ 
φρόντιζε	f ɾ o d̪ i z ɛ 
φρόντισε	f ɾ o d̪ i s ɛ 
φτιάνεις	f t̪ i ɐ n̪ i s 
φτιάξουν	f t̪ i ɐ k s u n̪ 
φτιάσεις	f t̪ i ɐ s i s 
φτυαράκι	f t̪ i ɐ ɾ ɐ k i 
φτωχικού	f t̪ o x i k u 
φτύσουμε	f t̪ i s u m ɛ 
φυλάγεις	f i l ɐ ɣ i s 
φωνάζετε	f o n̪ ɐ z ɛ t̪ ɛ 
φωνάξεις	f o n̪ ɐ k s i s 
φωνάξουν	f o n̪ ɐ k s u n̪ 
φωνήεντα	f o n̪ i ɛ d̪ ɐ 
φόρτωναν	f o ɾ t̪ o n̪ ɐ n̪ 
χάνοντας	x ɐ n̪ o d̪ ɐ s 
χαλάρωσε	x ɐ l ɐ ɾ o s ɛ 
χαλάσεις	x ɐ l ɐ s i s 
χαμόγελο	x ɐ m o ɣ ɛ l o 
χαντάκια	x ɐ d̪ ɐ k i ɐ 
χαραμάδα	x ɐ ɾ ɐ m ɐ ð ɐ 
χαριστής	x ɐ ɾ i s t̪ i s 
χαρτάκια	x ɐ ɾ t̪ ɐ k i ɐ 
χειμώνας	x i m o n̪ ɐ s 
χιλιάδες	x i l i ɐ ð ɛ s 
χιλιάδων	x i l i ɐ ð o n̪ 
χλώμιασε	x l o m i ɐ s ɛ 
χρήσιμος	x ɾ i s i m o s 
χρηστική	x ɾ i s t̪ i k i 
χτυπήσει	x t̪ i p i s i 
χτυπούσε	x t̪ i p u s ɛ 
χτύπησαν	x t̪ i p i s ɐ n̪ 
χτύπησες	x t̪ i p i s ɛ s 
χωρατεύω	x o ɾ ɐ t̪ ɛ v o 
χωρικούς	x o ɾ i k u s 
ψηλότερα	p s i l o t̪ ɛ ɾ ɐ 
ψιθύρισε	p s i θ i ɾ i s ɛ 
ψοφήσουν	p s o f i s u n̪ 
ωφελήσει	o f ɛ l i s i 
ωφεληθεί	o f ɛ l i θ i 
ωφελούμε	o f ɛ l u m ɛ 
Ιστιαίας-Αιδηψού	i s t̪ i ɛ ɐ s ɛ ð i p s u 
Σκάλισμα:	s k ɐ l i s m ɐ 
Αγκάλιασε	ɐ ɡ ɐ l i ɐ s ɛ 
Αλιβερίου	ɐ l i v ɛ ɾ i u 
Αμέτρητες	ɐ m ɛ t̪ ɾ i t̪ ɛ s 
Αμοιράκος	ɐ m i ɾ ɐ k o s 
Αμοιράκου	ɐ m i ɾ ɐ k u 
Αργεντινή	ɐ ɾ ɣ ɛ d̪ i n̪ i 
Αστόχαστο	ɐ s t̪ o x ɐ s t̪ o 
Ατρόμητος	ɐ t̪ ɾ o m i t̪ o s 
Αφανέρωτο	ɐ f ɐ n̪ ɛ ɾ o t̪ o 
Αφεντάδες	ɐ f ɛ d̪ ɐ ð ɛ s 
Βαριούμαι	v ɐ ɾ i u m ɛ 
Βασίλισσά	v ɐ s i l i s ɐ 
Βασίλισσα	v ɐ s i l i s ɐ 
Βασιλικός	v ɐ s i l i k o s 
Βρίσκεται	v ɾ i s k ɛ t̪ ɛ 
Γυρεύουμε	ɣ i ɾ ɛ v u m ɛ 
Διαλέγεις	ð i ɐ l ɛ ɣ i s 
Ειρηνούλα	i ɾ i n̪ u l ɐ 
Εξοχότατε	ɛ k s o x o t̪ ɐ t̪ ɛ 
Εξοχότητά	ɛ k s o x o t̪ i t̪ ɐ 
Εξοχώτατε	ɛ k s o x o t̪ ɐ t̪ ɛ 
Επιτέλους	ɛ p i t̪ ɛ l u s 
Επιτρόπου	ɛ p i t̪ ɾ o p u 
Ερημώθηκε	ɛ ɾ i m o θ i k ɛ 
Ευχαριστώ	ɛ f x ɐ ɾ i s t̪ o 
Εφημερίδα	ɛ f i m ɛ ɾ i ð ɐ 
Θυμούνταν	θ i m u d̪ ɐ n̪ 
Καθισμένη	k ɐ θ i s m ɛ n̪ i 
Καληνύχτα	k ɐ l i n̪ i x t̪ ɐ 
Καλησπέρα	k ɐ l i s p ɛ ɾ ɐ 
Κατάλαβες	k ɐ t̪ ɐ l ɐ v ɛ s 
Κατάστιχο	k ɐ t̪ ɐ s t̪ i x o 
Κατέβαινε	k ɐ t̪ ɛ v ɛ n̪ ɛ 
Κατέβηκαν	k ɐ t̪ ɛ v i k ɐ n̪ 
Καταδέξου	k ɐ t̪ ɐ ð ɛ k s u 
Κατόρθωσε	k ɐ t̪ o ɾ θ o s ɛ 
Κοιμήθηκε	k i m i θ i k ɛ 
Κολοκύθια	k o l o k i θ i ɐ 
Κρυμμένος	k ɾ i m ɛ n̪ o s 
Λαβώθηκες	l ɐ v o θ i k ɛ s 
Λαγόκαρδε	l ɐ ɣ o k ɐ ɾ ð ɛ 
Λαγόκαρδο	l ɐ ɣ o k ɐ ɾ ð o 
Λαργάρετε	l ɐ ɾ ɣ ɐ ɾ ɛ t̪ ɛ 
Λογάριαζε	l o ɣ ɐ ɾ i ɐ z ɛ 
Λογάριασα	l o ɣ ɐ ɾ i ɐ s ɐ 
Μαρμαρίου	m ɐ ɾ m ɐ ɾ i u 
Μπορούσες	b o ɾ u s ɛ s 
Ξαπλωμένο	k s ɐ p l o m ɛ n̪ o 
Ξεσκέπασε	k s ɛ s k ɛ p ɐ s ɛ 
Πατριώτες	p ɐ t̪ ɾ i o t̪ ɛ s 
Περιέργως	p ɛ ɾ i ɛ ɾ ɣ o s 
Περνούσαν	p ɛ ɾ n̪ u s ɐ n̪ 
Περνώντας	p ɛ ɾ n̪ o d̪ ɐ s 
Περπατάτε	p ɛ ɾ p ɐ t̪ ɐ t̪ ɛ 
Πηγαίνετε	p i ɣ ɛ n̪ ɛ t̪ ɛ 
Πικρόχολη	p i k ɾ o x o l i 
Πιλαλούσε	p i l ɐ l u s ɛ 
Πολύδωρος	p o l i ð o ɾ o s 
Πολύδωρου	p o l i ð o ɾ u 
Πολύκαρπε	p o l i k ɐ ɾ p ɛ 
Πολύκαρπο	p o l i k ɐ ɾ p o 
Προχώρησε	p ɾ o x o ɾ i s ɛ 
Σηκώθηκαν	s i k o θ i k ɐ n̪ 
Σκεφτείτε	s k ɛ f t̪ i t̪ ɛ 
Σκοτώθηκε	s k o t̪ o θ i k ɛ 
Σκυμμένος	s k i m ɛ n̪ o s 
Σταμάτησε	s t̪ ɐ m ɐ t̪ i s ɛ 
Συγχώρηση	s i ɣ x o ɾ i s i 
Τρέμοντας	t̪ ɾ ɛ m o d̪ ɐ s 
Τραβώντας	t̪ ɾ ɐ v o d̪ ɐ s 
Τρελάθηκα	t̪ ɾ ɛ l ɐ θ i k ɐ 
Τρελόρεμα	t̪ ɾ ɛ l o ɾ ɛ m ɐ 
Τρομάξαμε	t̪ ɾ o m ɐ k s ɐ m ɛ 
Τυλίχθηκε	t̪ i l i x θ i k ɛ 
Υπουργείο	i p u ɾ ɣ i o 
Φτωχούλης	f t̪ o x u l i s 
έρχουμουν	ɛ ɾ x u m u n̪ 
έρχουνταν	ɛ ɾ x u d̪ ɐ n̪ 
ήρχουνταν	i ɾ x u d̪ ɐ n̪ 
αγαπήσουν	ɐ ɣ ɐ p i s u n̪ 
αγαπημένη	ɐ ɣ ɐ p i m ɛ n̪ i 
αγαπημένο	ɐ ɣ ɐ p i m ɛ n̪ o 
αγκάλιασε	ɐ ɡ ɐ l i ɐ s ɛ 
αγοράσεις	ɐ ɣ o ɾ ɐ s i s 
αγοράσουν	ɐ ɣ o ɾ ɐ s u n̪ 
αγριεμένα	ɐ ɣ ɾ i ɛ m ɛ n̪ ɐ 
αγριεμένο	ɐ ɣ ɾ i ɛ m ɛ n̪ o 
αγρόκτημα	ɐ ɣ ɾ o k t̪ i m ɐ 
αδελφάκια	ɐ ð ɛ l f ɐ k i ɐ 
αδελφούλα	ɐ ð ɛ l f u l ɐ 
αδιάφορος	ɐ ð i ɐ f o ɾ o s 
αδιαφορία	ɐ ð i ɐ f o ɾ i ɐ 
αδούλευτα	ɐ ð u l ɛ f t̪ ɐ 
αειφορίας	ɐ i f o ɾ i ɐ s 
αετουδάκι	ɐ ɛ t̪ u ð ɐ k i 
ακονίσετε	ɐ k o n̪ i s ɛ t̪ ɛ 
ακουμπάει	ɐ k u b ɐ i 
ακούμπησε	ɐ k u b i s ɛ 
ακούονται	ɐ k u o d̪ ɛ 
ακούοντας	ɐ k u o d̪ ɐ s 
ακούραστα	ɐ k u ɾ ɐ s t̪ ɐ 
ακούσουμε	ɐ k u s u m ɛ 
ακούστηκε	ɐ k u s t̪ i k ɛ 
ακράτητος	ɐ k ɾ ɐ t̪ i t̪ o s 
αλλάζεται	ɐ l ɐ z ɛ t̪ ɛ 
αλλαγμένο	ɐ l ɐ ɣ m ɛ n̪ o 
αλλιώτικα	ɐ l i o t̪ i k ɐ 
ανάπτυξης	ɐ n̪ ɐ p t̪ i k s i s 
ανάστατος	ɐ n̪ ɐ s t̪ ɐ t̪ o s 
αναίσθητο	ɐ n̪ ɛ s θ i t̪ o 
αναγκάζει	ɐ n̪ ɐ ɡ ɐ z i 
αναγκαίος	ɐ n̪ ɐ ɡ ɛ o s 
αναζήτηση	ɐ n̪ ɐ z i t̪ i s i 
ανακάλυψε	ɐ n̪ ɐ k ɐ l i p s ɛ 
αναμεταξύ	ɐ n̪ ɐ m ɛ t̪ ɐ k s i 
ανανέωσαν	ɐ n̪ ɐ n̪ ɛ o s ɐ n̪ 
αναπήδησε	ɐ n̪ ɐ p i ð i s ɛ 
αναπτύξει	ɐ n̪ ɐ p t̪ i k s i 
ανασάνεις	ɐ n̪ ɐ s ɐ n̪ i s 
ανατολική	ɐ n̪ ɐ t̪ o l i k i 
αναφιλητά	ɐ n̪ ɐ f i l i t̪ ɐ 
αναφιλητό	ɐ n̪ ɐ f i l i t̪ o 
αναφώνησε	ɐ n̪ ɐ f o n̪ i s ɛ 
ανεβάζουν	ɐ n̪ ɛ v ɐ z u n̪ 
ανεβαίνει	ɐ n̪ ɛ v ɛ n̪ i 
ανησυχίες	ɐ n̪ i s i x i ɛ s 
ανθρωπάκι	ɐ n̪ θ ɾ o p ɐ k i 
ανθρώπινη	ɐ n̪ θ ɾ o p i n̪ i 
ανθρώπινο	ɐ n̪ θ ɾ o p i n̪ o 
ανθρώπους	ɐ n̪ θ ɾ o p u s 
ανιχνευτή	ɐ n̪ i x n̪ ɛ f t̪ i 
αντάμωσαν	ɐ d̪ ɐ m o s ɐ n̪ 
αντέδρασε	ɐ d̪ ɛ ð ɾ ɐ s ɛ 
αντέξουμε	ɐ d̪ ɛ k s u m ɛ 
αντίδραση	ɐ d̪ i ð ɾ ɐ s i 
αντίκριζε	ɐ d̪ i k ɾ i z ɛ 
αντίσταση	ɐ d̪ i s t̪ ɐ s i 
αντικρινό	ɐ d̪ i k ɾ i n̪ o 
αντρίκεια	ɐ d̪ ɾ i k i ɐ 
αξιώματος	ɐ k s i o m ɐ t̪ o s 
απέραντες	ɐ p ɛ ɾ ɐ d̪ ɛ s 
απαντήσει	ɐ p ɐ d̪ i s i 
απελπισία	ɐ p ɛ l p i s i ɐ 
απευθείας	ɐ p ɛ f θ i ɐ s 
απλωμένος	ɐ p l o m ɛ n̪ o s 
αποκριθεί	ɐ p o k ɾ i θ i 
αποτελούν	ɐ p o t̪ ɛ l u n̪ 
απόβλητος	ɐ p o v l i t̪ o s 
αρραβώνες	ɐ ɾ ɐ v o n̪ ɛ s 
αστράγαλό	ɐ s t̪ ɾ ɐ ɣ ɐ l o 
ατέλειωτη	ɐ t̪ ɛ l i o t̪ i 
ατελείωτο	ɐ t̪ ɛ l i o t̪ o 
αυτοθυσία	ɐ f t̪ o θ i s i ɐ 
αφάνταστα	ɐ f ɐ d̪ ɐ s t̪ ɐ 
αφέγγαρης	ɐ f ɛ ɡ ɐ ɾ i s 
αφήνοντας	ɐ f i n̪ o d̪ ɐ s 
αφηρημένα	ɐ f i ɾ i m ɛ n̪ ɐ 
αφιλόξενο	ɐ f i l o k s ɛ n̪ o 
βαθούλωμα	v ɐ θ u l o m ɐ 
βαλανιδιά	v ɐ l ɐ n̪ i ð i ɐ 
βαριούμαι	v ɐ ɾ i u m ɛ 
βασίλεψες	v ɐ s i l ɛ p s ɛ s 
βασιλέψει	v ɐ s i l ɛ p s i 
βασιλείου	v ɐ s i l i u 
βαστούσαν	v ɐ s t̪ u s ɐ n̪ 
βαστώντας	v ɐ s t̪ o d̪ ɐ s 
βγάζοντας	v ɣ ɐ z o d̪ ɐ s 
βεβαιωθεί	v ɛ v ɛ o θ i 
βιαστικός	v i ɐ s t̪ i k o s 
βιολογικά	v i o l o ɣ i k ɐ 
βλάστησης	v l ɐ s t̪ i s i s 
βλέποντας	v l ɛ p o d̪ ɐ s 
βοηθήσεις	v o i θ i s i s 
βουβάθηκε	v u v ɐ θ i k ɛ 
βουτώντας	v u t̪ o d̪ ɐ s 
βούρκωναν	v u ɾ k o n̪ ɐ n̪ 
βρίσκεται	v ɾ i s k ɛ t̪ ɛ 
βραδιάσει	v ɾ ɐ ð i ɐ s i 
βρισκόταν	v ɾ i s k o t̪ ɐ n̪ 
βρώμικους	v ɾ o m i k u s 
γίνουμουν	ɣ i n̪ u m u n̪ 
γίνουνταν	ɣ i n̪ u d̪ ɐ n̪ 
γαλόπουλο	ɣ ɐ l o p u l o 
γειτονικά	ɣ i t̪ o n̪ i k ɐ 
γειτονικό	ɣ i t̪ o n̪ i k o 
γεματούλα	ɣ ɛ m ɐ t̪ u l ɐ 
γεννήθηκα	ɣ ɛ n̪ n̪ i θ i k ɐ 
γεννήματα	ɣ ɛ n̪ n̪ i m ɐ t̪ ɐ 
γεροντάκι	ɣ ɛ ɾ o d̪ ɐ k i 
γεωργικών	ɣ ɛ o ɾ ɣ i k o n̪ 
γκρέμισαν	ɡ ɾ ɛ m i s ɐ n̪ 
γκρεμίσει	ɡ ɾ ɛ m i s i 
γλιστράνε	ɣ l i s t̪ ɾ ɐ n̪ ɛ 
γλιτώσεις	ɣ l i t̪ o s i s 
γονάτισαν	ɣ o n̪ ɐ t̪ i s ɐ n̪ 
γραμματέα	ɣ ɾ ɐ m ɐ t̪ ɛ ɐ 
γρηγοράδα	ɣ ɾ i ɣ o ɾ ɐ ð ɐ 
γυναικεία	ɣ i n̪ ɛ k i ɐ 
γυρισμένη	ɣ i ɾ i s m ɛ n̪ i 
γυρνούσες	ɣ i ɾ n̪ u s ɛ s 
γυρνώντας	ɣ i ɾ n̪ o d̪ ɐ s 
δασωμένες	ð ɐ s o m ɛ n̪ ɛ s 
διάγραμμα	ð i ɐ ɣ ɾ ɐ m ɐ 
διάδρομοι	ð i ɐ ð ɾ o m i 
διέσχιζαν	ð i ɛ s x i z ɐ n̪ 
διαβάζεις	ð i ɐ v ɐ z i s 
διαβάζετε	ð i ɐ v ɐ z ɛ t̪ ɛ 
διαβάσουν	ð i ɐ v ɐ s u n̪ 
διαβαίνει	ð i ɐ v ɛ n̪ i 
διαδρόμου	ð i ɐ ð ɾ o m u 
διαιτητής	ð i ɛ t̪ i t̪ i s 
διαλεχτήν	ð i ɐ l ɛ x t̪ i n̪ 
διαλυτικά	ð i ɐ l i t̪ i k ɐ 
διαμάντια	ð i ɐ m ɐ d̪ i ɐ 
διατάξεις	ð i ɐ t̪ ɐ k s i s 
διατήρηση	ð i ɐ t̪ i ɾ i s i 
διεύθυνση	ð i ɛ f θ i n̪ s i 
διηγήθηκε	ð i ɣ i θ i k ɛ 
διπλωμένα	ð i p l o m ɛ n̪ ɐ 
διπλωμένο	ð i p l o m ɛ n̪ o 
δοκιμάσει	ð o k i m ɐ s i 
δουλέψεις	ð u l ɛ p s i s 
δουλέψουν	ð u l ɛ p s u n̪ 
δουλεύαμε	ð u l ɛ v ɐ m ɛ 
δουλεύεις	ð u l ɛ v i s 
δουλεύετε	ð u l ɛ v ɛ t̪ ɛ 
δουλεύομε	ð u l ɛ v o m ɛ 
δουλεύουν	ð u l ɛ v u n̪ 
δυσάρεστα	ð i s ɐ ɾ ɛ s t̪ ɐ 
δυσάρεστη	ð i s ɐ ɾ ɛ s t̪ i 
δυσκολίες	ð i s k o l i ɛ s 
δυστυχίας	ð i s t̪ i x i ɐ s 
δυστυχίες	ð i s t̪ i x i ɛ s 
εβδομάδες	ɛ v ð o m ɐ ð ɛ s 
εγκρίνεις	ɛ ɡ ɾ i n̪ i s 
εισβάλλει	i s v ɐ l i 
εισβάλουν	i s v ɐ l u n̪ 
εκδικηθεί	ɛ k ð i k i θ i 
ελευθερία	ɛ l ɛ f θ ɛ ɾ i ɐ 
ελεύθερος	ɛ l ɛ f θ ɛ ɾ o s 
εμποδίσει	ɛ b o ð i s i 
εννοήσεις	ɛ n̪ n̪ o i s i s 
ενοχλείτε	ɛ n̪ o x l i t̪ ɛ 
ενοχλούμε	ɛ n̪ o x l u m ɛ 
εξάδελφος	ɛ k s ɐ ð ɛ l f o s 
εξαδέλφου	ɛ k s ɐ ð ɛ l f u 
εξακοσίων	ɛ k s ɐ k o s i o n̪ 
εξετάσεις	ɛ k s ɛ t̪ ɐ s i s 
εξηγήσεις	ɛ k s i ɣ i s i s 
εξωτερικά	ɛ k s o t̪ ɛ ɾ i k ɐ 
επέστρεψε	ɛ p ɛ s t̪ ɾ ɛ p s ɛ 
επίκεντρο	ɛ p i k ɛ d̪ ɾ o 
επανέλαβε	ɛ p ɐ n̪ ɛ l ɐ v ɛ 
επανωφόρι	ɛ p ɐ n̪ o f o ɾ i 
επιστρέψω	ɛ p i s t̪ ɾ ɛ p s o 
επιτέλους	ɛ p i t̪ ɛ l u s 
επιτήρηση	ɛ p i t̪ i ɾ i s i 
επιφάνεια	ɛ p i f ɐ n̪ i ɐ 
επρόδωσες	ɛ p ɾ o ð o s ɛ s 
επωφεληθώ	ɛ p o f ɛ l i θ o 
εργαλείων	ɛ ɾ ɣ ɐ l i o n̪ 
εργαστήρι	ɛ ɾ ɣ ɐ s t̪ i ɾ i 
εργαστείς	ɛ ɾ ɣ ɐ s t̪ i s 
εσπρεσάκι	ɛ s p ɾ ɛ s ɐ k i 
εσωτερική	ɛ s o t̪ ɛ ɾ i k i 
εσωτερικό	ɛ s o t̪ ɛ ɾ i k o 
ετοιμάσει	ɛ t̪ i m ɐ s i 
ευγενικός	ɛ v ɣ ɛ n̪ i k o s 
ευκόλυνες	ɛ f k o l i n̪ ɛ s 
ευχαριστώ	ɛ f x ɐ ɾ i s t̪ o 
εφοβήθηκα	ɛ f o v i θ i k ɐ 
ζαλισμένα	z ɐ l i s m ɛ n̪ ɐ 
ζαλισμένο	z ɐ l i s m ɛ n̪ o 
ζεστάνεις	z ɛ s t̪ ɐ n̪ i s 
ζητιάνους	z i t̪ i ɐ n̪ u s 
ζητιανέψω	z i t̪ i ɐ n̪ ɛ p s o 
ζητούμενο	z i t̪ u m ɛ n̪ o 
ζωγράφισε	z o ɣ ɾ ɐ f i s ɛ 
ζωολογικό	z o l o ɣ i k o 
ησυχότατο	i s i x o t̪ ɐ t̪ o 
θαμπώνουν	θ ɐ b o n̪ u n̪ 
θησαυρούς	θ i s ɐ v ɾ u s 
θλιμμένος	θ l i m ɛ n̪ o s 
θυμωμένες	θ i m o m ɛ n̪ ɛ s 
θυμωμένος	θ i m o m ɛ n̪ o s 
ιδιαίτερη	i ð i ɛ t̪ ɛ ɾ i 
ιδρωμένος	i ð ɾ o m ɛ n̪ o s 
κάθουμουν	k ɐ θ u m u n̪ 
κάθουνταν	k ɐ θ u d̪ ɐ n̪ 
καβαλάρης	k ɐ v ɐ l ɐ ɾ i s 
καθισμένη	k ɐ θ i s m ɛ n̪ i 
καθισμένο	k ɐ θ i s m ɛ n̪ o 
καθόμαστε	k ɐ θ o m ɐ s t̪ ɛ 
καινούρια	k ɛ n̪ u ɾ i ɐ 
καινούριο	k ɛ n̪ u ɾ i o 
κακιώματα	k ɐ k i o m ɐ t̪ ɐ 
κακοήθεια	k ɐ k o i θ i ɐ 
κακομοίρα	k ɐ k o m i ɾ ɐ 
κακόμοιρο	k ɐ k o m i ɾ o 
καλύτεροι	k ɐ l i t̪ ɛ ɾ i 
καλύτερος	k ɐ l i t̪ ɛ ɾ o s 
καμάρωσες	k ɐ m ɐ ɾ o s ɛ s 
καμπούρης	k ɐ b u ɾ i s 
καμτσικιά	k ɐ m t̪ s i k i ɐ 
καρφωμένη	k ɐ ɾ f o m ɛ n̪ i 
κατάλαβες	k ɐ t̪ ɐ l ɐ v ɛ s 
κατάξερος	k ɐ t̪ ɐ k s ɛ ɾ o s 
κατάσταση	k ɐ t̪ ɐ s t̪ ɐ s i 
κατάφεραν	k ɐ t̪ ɐ f ɛ ɾ ɐ n̪ 
κατάφερες	k ɐ t̪ ɐ f ɛ ɾ ɛ s 
κατάφθανε	k ɐ t̪ ɐ f θ ɐ n̪ ɛ 
κατάχλωμο	k ɐ t̪ ɐ x l o m o 
κατέβαζαν	k ɐ t̪ ɛ v ɐ z ɐ n̪ 
κατέβαινα	k ɐ t̪ ɛ v ɛ n̪ ɐ 
κατέβαινε	k ɐ t̪ ɛ v ɛ n̪ ɛ 
κατέβηκαν	k ɐ t̪ ɛ v i k ɐ n̪ 
κατήντησε	k ɐ t̪ i d̪ i s ɛ 
καταδεχθώ	k ɐ t̪ ɐ ð ɛ x θ o 
κατακτήσω	k ɐ t̪ ɐ k t̪ i s o 
καταλάβει	k ɐ t̪ ɐ l ɐ v i 
καταστολή	k ɐ t̪ ɐ s t̪ o l i 
καταφέρει	k ɐ t̪ ɐ f ɛ ɾ i 
κατεβάζει	k ɐ t̪ ɛ v ɐ z i 
κατεβάσει	k ɐ t̪ ɛ v ɐ s i 
κατεβούμε	k ɐ t̪ ɛ v u m ɛ 
κατρακύλι	k ɐ t̪ ɾ ɐ k i l i 
καφενείου	k ɐ f ɛ n̪ i u 
κεντήματά	k ɛ d̪ i m ɐ t̪ ɐ 
κεντημένη	k ɛ d̪ i m ɛ n̪ i 
κερδίζαμε	k ɛ ɾ ð i z ɐ m ɛ 
κλειδαριά	k l i ð ɐ ɾ i ɐ 
κλειδώσει	k l i ð o s i 
κλεισμένη	k l i s m ɛ n̪ i 
κλεμμένος	k l ɛ m ɛ n̪ o s 
κοιμηθείς	k i m i θ i s 
κοινότητα	k i n̪ o t̪ i t̪ ɐ 
κοιτώντας	k i t̪ o d̪ ɐ s 
κοκκίνιζε	k o k i n̪ i z ɛ 
κοκκίνισε	k o k i n̪ i s ɛ 
κοκκινάδα	k o k i n̪ ɐ ð ɐ 
κομμένους	k o m ɛ n̪ u s 
κομπολόγι	k o b o l o ɣ i 
κοπελίτσα	k o p ɛ l i t̪ s ɐ 
κοπιάζεις	k o p i ɐ z i s 
κοριτσιών	k o ɾ i t̪ s i o n̪ 
κοροϊδεύω	k o ɾ o i ð ɛ v o 
κοτόπουλο	k o t̪ o p u l o 
κουνήσουν	k u n̪ i s u n̪ 
κουνελάκι	k u n̪ ɛ l ɐ k i 
κουτσοζεί	k u t̪ s o z i 
κούτσουρο	k u t̪ s u ɾ o 
κρέμονταν	k ɾ ɛ m o d̪ ɐ n̪ 
κρασάδικο	k ɾ ɐ s ɐ ð i k o 
κρατήθηκε	k ɾ ɐ t̪ i θ i k ɛ 
κρατώντας	k ɾ ɐ t̪ o d̪ ɐ s 
κρεμμύδια	k ɾ ɛ m i ð i ɐ 
κρύβονται	k ɾ i v o d̪ ɛ 
κρύβοντας	k ɾ i v o d̪ ɐ s 
κυνηγούσα	k i n̪ i ɣ u s ɐ 
κυνηγούσε	k i n̪ i ɣ u s ɛ 
λαίμαργες	l ɛ m ɐ ɾ ɣ ɛ s 
λεωφορείο	l ɛ o f o ɾ i o 
λιποταξία	l i p o t̪ ɐ k s i ɐ 
λουλούδια	l u l u ð i ɐ 
μέρανύχτα	m ɛ ɾ ɐ n̪ i x t̪ ɐ 
μαγειρεύω	m ɐ ɣ i ɾ ɛ v o 
μαγειριού	m ɐ ɣ i ɾ i u 
μαζεμένες	m ɐ z ɛ m ɛ n̪ ɛ s 
μαζεμένοι	m ɐ z ɛ m ɛ n̪ i 
μαζεμένος	m ɐ z ɛ m ɛ n̪ o s 
μαθαίνεις	m ɐ θ ɛ n̪ i s 
μαθαίνουν	m ɐ θ ɛ n̪ u n̪ 
μακρύτερα	m ɐ k ɾ i t̪ ɛ ɾ ɐ 
μαντιλιού	m ɐ d̪ i l i u 
μαξιλάρια	m ɐ k s i l ɐ ɾ i ɐ 
μεγαλώσει	m ɛ ɣ ɐ l o s i 
μελάνιασε	m ɛ l ɐ n̪ i ɐ s ɛ 
μελαχρινή	m ɛ l ɐ x ɾ i n̪ i 
μελετήσει	m ɛ l ɛ t̪ i s i 
μελόπιτες	m ɛ l o p i t̪ ɛ s 
μερμήγκια	m ɛ ɾ m i ɡ i ɐ 
μεσάνυχτα	m ɛ s ɐ n̪ i x t̪ ɐ 
μεσόκοπος	m ɛ s o k o p o s 
μεταλλεία	m ɛ t̪ ɐ l i ɐ 
μεταλλείο	m ɛ t̪ ɐ l i o 
μετρημένα	m ɛ t̪ ɾ i m ɛ n̪ ɐ 
μοιραστεί	m i ɾ ɐ s t̪ i 
μονοτονία	m o n̪ o t̪ o n̪ i ɐ 
μούγκρισε	m u ɡ ɾ i s ɛ 
μούδιασαν	m u ð i ɐ s ɐ n̪ 
μπήγοντας	b i ɣ o d̪ ɐ s 
μπήχθηκαν	b i x θ i k ɐ n̪ 
μπακάλικο	b ɐ k ɐ l i k o 
μπαλωματή	b ɐ l o m ɐ t̪ i 
μπαμπούλα	b ɐ b u l ɐ 
μπορέσεις	b o ɾ ɛ s i s 
μπορούσαν	b o ɾ u s ɐ n̪ 
μπορούσες	b o ɾ u s ɛ s 
μποτίλιας	b o t̪ i l i ɐ s 
μποτίλιες	b o t̪ i l i ɛ s 
μπουγάδας	b u ɣ ɐ ð ɐ s 
μπροστινή	b ɾ o s t̪ i n̪ i 
ναύσταθμο	n̪ ɐ f s t̪ ɐ θ m o 
νησιώτικο	n̪ i s i o t̪ i k o 
νοιάστηκε	n̪ i ɐ s t̪ i k ɛ 
νοσηλείας	n̪ o s i l i ɐ s 
νοσοκόμες	n̪ o s o k o m ɛ s 
νοσοκόμος	n̪ o s o k o m o s 
νοσοκόμων	n̪ o s o k o m o n̪ 
νοστιμάδα	n̪ o s t̪ i m ɐ ð ɐ 
ντουλάπια	d̪ u l ɐ p i ɐ 
νυχτερινό	n̪ i x t̪ ɛ ɾ i n̪ o 
ξάφνιασμα	k s ɐ f n̪ i ɐ s m ɐ 
ξανάβλεπα	k s ɐ n̪ ɐ v l ɛ p ɐ 
ξανάμπηξε	k s ɐ n̪ ɐ b i k s ɛ 
ξανάπιασε	k s ɐ n̪ ɐ p i ɐ s ɛ 
ξανάρθουν	k s ɐ n̪ ɐ ɾ θ u n̪ 
ξανάρχιζε	k s ɐ n̪ ɐ ɾ x i z ɛ 
ξανάρχισε	k s ɐ n̪ ɐ ɾ x i s ɛ 
ξαναείδες	k s ɐ n̪ ɐ i ð ɛ s 
ξαναμάθει	k s ɐ n̪ ɐ m ɐ θ i 
ξαναχτίσω	k s ɐ n̪ ɐ x t̪ i s o 
ξαπλωμένη	k s ɐ p l o m ɛ n̪ i 
ξαπλωμένο	k s ɐ p l o m ɛ n̪ o 
ξαπλώθηκε	k s ɐ p l o θ i k ɛ 
ξεκινούσε	k s ɛ k i n̪ u s ɛ 
ξεκούραση	k s ɛ k u ɾ ɐ s i 
ξεμύτιζαν	k s ɛ m i t̪ i z ɐ n̪ 
ξεπούλησε	k s ɛ p u l i s ɛ 
ξεσκέπασε	k s ɛ s k ɛ p ɐ s ɛ 
ξεσπάσουν	k s ɛ s p ɐ s u n̪ 
ξεφόρτωσε	k s ɛ f o ɾ t̪ o s ɛ 
ξεφώλιαζε	k s ɛ f o l i ɐ z ɛ 
ξεφώνιζαν	k s ɛ f o n̪ i z ɐ n̪ 
ξεχασμένα	k s ɛ x ɐ s m ɛ n̪ ɐ 
ξεχνώντας	k s ɛ x n̪ o d̪ ɐ s 
ξεχωρίσει	k s ɛ x o ɾ i s i 
ξεχύνεται	k s ɛ x i n̪ ɛ t̪ ɛ 
ξεψυχήσει	k s ɛ p s i x i s i 
ξοδευτούν	k s o ð ɛ f t̪ u n̪ 
ξοδιάσεις	k s o ð i ɐ s i s 
ξυλαράκια	k s i l ɐ ɾ ɐ k i ɐ 
ξυλοκόποι	k s i l o k o p i 
ξυλοκόπος	k s i l o k o p o s 
ξυπνητήρι	k s i p n̪ i t̪ i ɾ i 
ξυπνούσες	k s i p n̪ u s ɛ s 
οδηγήσεις	o ð i ɣ i s i s 
οδηγήσουν	o ð i ɣ i s u n̪ 
ολόκληρον	o l o k l i ɾ o n̪ 
ολόκληρος	o l o k l i ɾ o s 
ομοιότητα	o m i o t̪ i t̪ ɐ 
οπλίσουμε	o p l i s u m ɛ 
ορεκτικοί	o ɾ ɛ k t̪ i k i 
ορκίζομαι	o ɾ k i z o m ɛ 
ορτσωμένα	o ɾ t̪ s o m ɛ n̪ ɐ 
πέτρινους	p ɛ t̪ ɾ i n̪ u s 
πέφτοντας	p ɛ f t̪ o d̪ ɐ s 
παίζοντας	p ɛ z o d̪ ɐ s 
παινιέσαι	p ɛ n̪ i ɛ s ɛ 
παιχνίδια	p ɛ x n̪ i ð i ɐ 
παλατιανό	p ɐ l ɐ t̪ i ɐ n̪ o 
παλικάρια	p ɐ l i k ɐ ɾ i ɐ 
παλικαράς	p ɐ l i k ɐ ɾ ɐ s 
παλιωμένη	p ɐ l i o m ɛ n̪ i 
παλιωμένο	p ɐ l i o m ɛ n̪ o 
παμπάλαιο	p ɐ b ɐ l ɛ o 
πανέμορφο	p ɐ n̪ ɛ m o ɾ f o 
παντοτινή	p ɐ d̪ o t̪ i n̪ i 
παξιμάδια	p ɐ k s i m ɐ ð i ɐ 
παπούτσια	p ɐ p u t̪ s i ɐ 
παππούλης	p ɐ p u l i s 
παράγοντα	p ɐ ɾ ɐ ɣ o d̪ ɐ 
παράλληλα	p ɐ ɾ ɐ l i l ɐ 
παράξενες	p ɐ ɾ ɐ k s ɛ n̪ ɛ s 
παράξενος	p ɐ ɾ ɐ k s ɛ n̪ o s 
παράτησαν	p ɐ ɾ ɐ t̪ i s ɐ n̪ 
παραγιούς	p ɐ ɾ ɐ ɣ i u s 
παραγωγής	p ɐ ɾ ɐ ɣ o ɣ i s 
παραδίνει	p ɐ ɾ ɐ ð i n̪ i 
παραδώσει	p ɐ ɾ ɐ ð o s i 
παραθύρου	p ɐ ɾ ɐ θ i ɾ u 
παρακόρες	p ɐ ɾ ɐ k o ɾ ɛ s 
παραμύθια	p ɐ ɾ ɐ m i θ i ɐ 
παραξενιά	p ɐ ɾ ɐ k s ɛ n̪ i ɐ 
παρατήσει	p ɐ ɾ ɐ t̪ i s i 
παραφέντη	p ɐ ɾ ɐ f ɛ d̪ i 
παστίτσιο	p ɐ s t̪ i t̪ s i o 
πατημένες	p ɐ t̪ i m ɛ n̪ ɛ s 
πατούσαμε	p ɐ t̪ u s ɐ m ɛ 
πατριώτες	p ɐ t̪ ɾ i o t̪ ɛ s 
πατριώτης	p ɐ t̪ ɾ i o t̪ i s 
πεθαίνουν	p ɛ θ ɛ n̪ u n̪ 
πεθαμένος	p ɛ θ ɐ m ɛ n̪ o s 
πεθαμένου	p ɛ θ ɐ m ɛ n̪ u 
πενηντάρα	p ɛ n̪ i d̪ ɐ ɾ ɐ 
πεποίθηση	p ɛ p i θ i s i 
περίγραψε	p ɛ ɾ i ɣ ɾ ɐ p s ɛ 
περίεργες	p ɛ ɾ i ɛ ɾ ɣ ɛ s 
περίεργος	p ɛ ɾ i ɛ ɾ ɣ o s 
περίμεναν	p ɛ ɾ i m ɛ n̪ ɐ n̪ 
περίμενες	p ɛ ɾ i m ɛ n̪ ɛ s 
περίσταση	p ɛ ɾ i s t̪ ɐ s i 
περασμένα	p ɛ ɾ ɐ s m ɛ n̪ ɐ 
περασμένη	p ɛ ɾ ɐ s m ɛ n̪ i 
περγαμηνή	p ɛ ɾ ɣ ɐ m i n̪ i 
περιέχουν	p ɛ ɾ i ɛ x u n̪ 
περιβόλια	p ɛ ɾ i v o l i ɐ 
περιμένει	p ɛ ɾ i m ɛ n̪ i 
περιουσία	p ɛ ɾ i u s i ɐ 
περνούσες	p ɛ ɾ n̪ u s ɛ s 
περνώντας	p ɛ ɾ n̪ o d̪ ɐ s 
περπάτημα	p ɛ ɾ p ɐ t̪ i m ɐ 
περπατήσω	p ɛ ɾ p ɐ t̪ i s o 
περπατούν	p ɛ ɾ p ɐ t̪ u n̪ 
πεσμένους	p ɛ s m ɛ n̪ u s 
πηγαίναμε	p i ɣ ɛ n̪ ɐ m ɛ 
πηγαίνεις	p i ɣ ɛ n̪ i s 
πηγαίνομε	p i ɣ ɛ n̪ o m ɛ 
πηγαίνουν	p i ɣ ɛ n̪ u n̪ 
πιάνοντας	p i ɐ n̪ o d̪ ɐ s 
πιστέψεις	p i s t̪ ɛ p s i s 
πιστέψετε	p i s t̪ ɛ p s ɛ t̪ ɛ 
πιστέψουν	p i s t̪ ɛ p s u n̪ 
πιστεύουν	p i s t̪ ɛ v u n̪ 
πλάγιασες	p l ɐ ɣ i ɐ s ɛ s 
πληγιάσει	p l i ɣ i ɐ s i 
πληγωμένο	p l i ɣ o m ɛ n̪ o 
πληθυσμός	p l i θ i s m o s 
πληρωθούν	p l i ɾ o θ u n̪ 
πληρώνεις	p l i ɾ o n̪ i s 
πλησιάζει	p l i s i ɐ z i 
πλησιάσει	p l i s i ɐ s i 
πλουμιστή	p l u m i s t̪ i 
πλούσιους	p l u s i u s 
ποδαράκια	p o ð ɐ ɾ ɐ k i ɐ 
ποκαμίσου	p o k ɐ m i s u 
πολυθρόνα	p o l i θ ɾ o n̪ ɐ 
πολύτιμες	p o l i t̪ i m ɛ s 
πονοψυχιά	p o n̪ o p s i x i ɐ 
πουκάμισο	p u k ɐ m i s o 
πουλήσεις	p u l i s i s 
πουλούσαν	p u l u s ɐ n̪ 
πουλώντας	p u l o d̪ ɐ s 
πρήστηκαν	p ɾ i s t̪ i k ɐ n̪ 
πρακτικές	p ɾ ɐ k t̪ i k ɛ s 
πρακτικής	p ɾ ɐ k t̪ i k i s 
προμήθευε	p ɾ o m i θ ɛ v ɛ 
προσθέσει	p ɾ o s θ ɛ s i 
προστάξει	p ɾ o s t̪ ɐ k s i 
προσταγές	p ɾ o s t̪ ɐ ɣ ɛ s 
προστασία	p ɾ o s t̪ ɐ s i ɐ 
προσχέδιο	p ɾ o s x ɛ ð i o 
προσωπική	p ɾ o s o p i k i 
προτάσεις	p ɾ o t̪ ɐ s i s 
προφθάσει	p ɾ o f θ ɐ s i 
προφθαίνω	p ɾ o f θ ɛ n̪ o 
προφτάσει	p ɾ o f t̪ ɐ s i 
προχώρησε	p ɾ o x o ɾ i s ɛ 
προϊόντος	p ɾ o i o d̪ o s 
προϊόντων	p ɾ o i o d̪ o n̪ 
πρωτοκάνω	p ɾ o t̪ o k ɐ n̪ o 
πρωτύτερα	p ɾ o t̪ i t̪ ɛ ɾ ɐ 
πρόγραμμα	p ɾ o ɣ ɾ ɐ m ɐ 
πρόκειται	p ɾ o k i t̪ ɛ 
πρόφθαινα	p ɾ o f θ ɛ n̪ ɐ 
πρόφθαινε	p ɾ o f θ ɛ n̪ ɛ 
πρόφθασαν	p ɾ o f θ ɐ s ɐ n̪ 
πρόφταινε	p ɾ o f t̪ ɛ n̪ ɛ 
ρίχνοντας	ɾ i x n̪ o d̪ ɐ s 
ραγισμένο	ɾ ɐ ɣ i s m ɛ n̪ o 
ρημαγμένο	ɾ i m ɐ ɣ m ɛ n̪ o 
ρωτήσουμε	ɾ o t̪ i s u m ɛ 
σάλπιγγας	s ɐ l p i ɡ ɐ s 
σέρνοντας	s ɛ ɾ n̪ o d̪ ɐ s 
σανιδένιο	s ɐ n̪ i ð ɛ n̪ i o 
σαϊτεύουν	s ɐ i t̪ ɛ v u n̪ 
σείστηκαν	s i s t̪ i k ɐ n̪ 
σεβασθούν	s ɛ v ɐ s θ u n̪ 
σεντούκια	s ɛ d̪ u k i ɐ 
σερβίρισε	s ɛ ɾ v i ɾ i s ɛ 
σηκώθηκαν	s i k o θ i k ɐ n̪ 
σηκώνεται	s i k o n̪ ɛ t̪ ɛ 
σημαντικό	s i m ɐ d̪ i k o 
σημερινής	s i m ɛ ɾ i n̪ i s 
σημερινού	s i m ɛ ɾ i n̪ u 
σιδερένια	s i ð ɛ ɾ ɛ n̪ i ɐ 
σιδερένιο	s i ð ɛ ɾ ɛ n̪ i o 
σκέπτεται	s k ɛ p t̪ ɛ t̪ ɛ 
σκεπαστεί	s k ɛ p ɐ s t̪ i 
σκεπαστός	s k ɛ p ɐ s t̪ o s 
σκεπτικός	s k ɛ p t̪ i k o s 
σκορδαλιά	s k o ɾ ð ɐ l i ɐ 
σκοτούρες	s k o t̪ u ɾ ɛ s 
σκοτωμένο	s k o t̪ o m ɛ n̪ o 
σκοτώσεις	s k o t̪ o s i s 
σκουντάει	s k u d̪ ɐ i 
σκουπίζει	s k u p i z i 
σκούπιζαν	s k u p i z ɐ n̪ 
σκύβοντας	s k i v o d̪ ɐ s 
σμίγοντας	s m i ɣ o d̪ ɐ s 
σπασμένης	s p ɐ s m ɛ n̪ i s 
στέκονταν	s t̪ ɛ k o d̪ ɐ n̪ 
σταμάτησε	s t̪ ɐ m ɐ t̪ i s ɛ 
σταματήσω	s t̪ ɐ m ɐ t̪ i s o 
στερεώσει	s t̪ ɛ ɾ ɛ o s i 
στιγμιαία	s t̪ i ɣ m i ɛ ɐ 
στουμπώνω	s t̪ u b o n̪ o 
στρατηγός	s t̪ ɾ ɐ t̪ i ɣ o s 
στρατιώτη	s t̪ ɾ ɐ t̪ i o t̪ i 
στρατώνες	s t̪ ɾ ɐ t̪ o n̪ ɛ s 
στριγκλιά	s t̪ ɾ i ɡ l i ɐ 
στριγλιές	s t̪ ɾ i ɣ l i ɛ s 
στριμώξει	s t̪ ɾ i m o k s i 
στρωμένοι	s t̪ ɾ o m ɛ n̪ i 
στρωμένος	s t̪ ɾ o m ɛ n̪ o s 
στόλαρχοι	s t̪ o l ɐ ɾ x i 
στόλαρχος	s t̪ o l ɐ ɾ x o s 
συγκίνηση	s i ɡ i n̪ i s i 
συγχώρηση	s i ɣ x o ɾ i s i 
συκοφάντη	s i k o f ɐ d̪ i 
συλλάβεις	s i l ɐ v i s 
συμβαίνει	s i m v ɛ n̪ i 
συμβατικά	s i m v ɐ t̪ i k ɐ 
συμβουλές	s i m v u l ɛ s 
συμμετοχή	s i m ɛ t̪ o x i 
συμπάθεια	s i b ɐ θ i ɐ 
συνάντηση	s i n̪ ɐ d̪ i s i 
συνένοχος	s i n̪ ɛ n̪ o x o s 
συνεργεία	s i n̪ ɛ ɾ ɣ i ɐ 
συνεργείο	s i n̪ ɛ ɾ ɣ i o 
συνεχίζει	s i n̪ ɛ x i z i 
συνημμένο	s i n̪ i m ɛ n̪ o 
συνοδεύει	s i n̪ o ð ɛ v i 
συνολικού	s i n̪ o l i k u 
συντροφιά	s i d̪ ɾ o f i ɐ 
σχεδιάζει	s x ɛ ð i ɐ z i 
σχεδιάσει	s x ɛ ð i ɐ s i 
σωματάρχη	s o m ɐ t̪ ɐ ɾ x i 
σύμβουλος	s i m v u l o s 
τέσσερεις	t̪ ɛ s ɛ ɾ i s 
ταράχθηκε	t̪ ɐ ɾ ɐ x θ i k ɛ 
ταράχτηκε	t̪ ɐ ɾ ɐ x t̪ i k ɛ 
ταραγμένη	t̪ ɐ ɾ ɐ ɣ m ɛ n̪ i 
τείνοντας	t̪ i n̪ o d̪ ɐ s 
τελείωσαν	t̪ ɛ l i o s ɐ n̪ 
τελειώνει	t̪ ɛ l i o n̪ i 
τελειώσει	t̪ ɛ l i o s i 
τελευταία	t̪ ɛ l ɛ f t̪ ɛ ɐ 
τελευταίο	t̪ ɛ l ɛ f t̪ ɛ o 
τεμπέλικα	t̪ ɛ b ɛ l i k ɐ 
τετραδίων	t̪ ɛ t̪ ɾ ɐ ð i o n̪ 
τηλεφώνου	t̪ i l ɛ f o n̪ u 
τιμωρούσε	t̪ i m o ɾ u s ɛ 
τινάχτηκε	t̪ i n̪ ɐ x t̪ i k ɛ 
τρέμοντας	t̪ ɾ ɛ m o d̪ ɐ s 
τρέχουσας	t̪ ɾ ɛ x u s ɐ s 
τραβήξουν	t̪ ɾ ɐ v i k s u n̪ 
τραβούσαν	t̪ ɾ ɐ v u s ɐ n̪ 
τραβώντας	t̪ ɾ ɐ v o d̪ ɐ s 
τραγούδια	t̪ ɾ ɐ ɣ u ð i ɐ 
τραπεζίτη	t̪ ɾ ɐ p ɛ z i t̪ i 
τρελάθηκα	t̪ ɾ ɛ l ɐ θ i k ɐ 
τρομάζεις	t̪ ɾ o m ɐ z i s 
τρυπημένη	t̪ ɾ i p i m ɛ n̪ i 
τσιγάριζε	t̪ s i ɣ ɐ ɾ i z ɛ 
τσιμπούκι	t̪ s i b u k i 
τυλίχθηκε	t̪ i l i x θ i k ɛ 
τυλιγμένο	t̪ i l i ɣ m ɛ n̪ o 
υβριστικά	i v ɾ i s t̪ i k ɐ 
υπασπιστή	i p ɐ s p i s t̪ i 
υπερήφανα	i p ɛ ɾ i f ɐ n̪ ɐ 
υπερήφανο	i p ɛ ɾ i f ɐ n̪ o 
υπηρεσίας	i p i ɾ ɛ s i ɐ s 
υποκλιθεί	i p o k l i θ i 
υποχρέωσε	i p o x ɾ ɛ o s ɛ 
υπόστρωμα	i p o s t̪ ɾ o m ɐ 
φαίνονται	f ɛ n̪ o d̪ ɛ 
φαίνονταν	f ɛ n̪ o d̪ ɐ n̪ 
φαμελίτες	f ɐ m ɛ l i t̪ ɛ s 
φεύγοντας	f ɛ v ɣ o d̪ ɐ s 
φθάνοντας	f θ ɐ n̪ o d̪ ɐ s 
φιλήθηκαν	f i l i θ i k ɐ n̪ 
φιλοξενία	f i l o k s ɛ n̪ i ɐ 
φιλοτιμία	f i l o t̪ i m i ɐ 
φλαμίνγκο	f l ɐ m i n̪ ɡ o 
φοβέριζαν	f o v ɛ ɾ i z ɐ n̪ 
φοβισμένα	f o v i s m ɛ n̪ ɐ 
φοβισμένη	f o v i s m ɛ n̪ i 
φοβούνται	f o v u d̪ ɛ 
φοβούνταν	f o v u d̪ ɐ n̪ 
φοιτήτρια	f i t̪ i t̪ ɾ i ɐ 
φορτωμένα	f o ɾ t̪ o m ɛ n̪ ɐ 
φορτωμένη	f o ɾ t̪ o m ɛ n̪ i 
φορτωμένο	f o ɾ t̪ o m ɛ n̪ o 
φουρτούνα	f u ɾ t̪ u n̪ ɐ 
φουστάνια	f u s t̪ ɐ n̪ i ɐ 
φροντίζει	f ɾ o d̪ i z i 
φρούραρχο	f ɾ u ɾ ɐ ɾ x o 
φυλλαράκι	f i l ɐ ɾ ɐ k i 
φωλιάζουν	f o l i ɐ z u n̪ 
φωνάξουμε	f o n̪ ɐ k s u m ɛ 
φωτισμένο	f o t̪ i s m ɛ n̪ o 
χαίρονταν	x ɛ ɾ o d̪ ɐ n̪ 
χαδιάρικα	x ɐ ð i ɐ ɾ i k ɐ 
χαιρέτησε	x ɛ ɾ ɛ t̪ i s ɛ 
χαιρέτισε	x ɛ ɾ ɛ t̪ i s ɛ 
χαλάσματα	x ɐ l ɐ s m ɐ t̪ ɐ 
χαμόκλαδα	x ɐ m o k l ɐ ð ɐ 
χαρακτήρα	x ɐ ɾ ɐ k t̪ i ɾ ɐ 
χαρούμενα	x ɐ ɾ u m ɛ n̪ ɐ 
χαρούμενη	x ɐ ɾ u m ɛ n̪ i 
χαρούμενο	x ɐ ɾ u m ɛ n̪ o 
χειράμαξα	x i ɾ ɐ m ɐ k s ɐ 
χειρότερα	x i ɾ o t̪ ɛ ɾ ɐ 
χιλίαρχος	x i l i ɐ ɾ x o s 
χολόσκανε	x o l o s k ɐ n̪ ɛ 
χορτάσεις	x o ɾ t̪ ɐ s i s 
χορταρικά	x o ɾ t̪ ɐ ɾ i k ɐ 
χρειαστεί	x ɾ i ɐ s t̪ i 
χτυπήσομε	x t̪ i p i s o m ɛ 
χτυπώντας	x t̪ i p o d̪ ɐ s 
χώνουνταν	x o n̪ u d̪ ɐ n̪ 
ψυχίατρος	p s i x i ɐ t̪ ɾ o s 
ωριμάζανε	o ɾ i m ɐ z ɐ n̪ ɛ 
ωφεληθείς	o f ɛ l i θ i s 
μεροδούλι-μεροφάγι	m ɛ ɾ o ð u l i m ɛ ɾ o f ɐ ɣ i 
μισομαύρο-μισοκίτρινο	m i s o m ɐ v ɾ o m i s o k i t̪ ɾ i n̪ o 
Θρασύμαχε·	θ ɾ ɐ s i m ɐ x ɛ 
Αγριόχορτα	ɐ ɣ ɾ i o x o ɾ t̪ ɐ 
Αναστήθηκε	ɐ n̪ ɐ s t̪ i θ i k ɛ 
Απεναντίας	ɐ p ɛ n̪ ɐ d̪ i ɐ s 
Αστόχαστος	ɐ s t̪ o x ɐ s t̪ o s 
Αστόχαστου	ɐ s t̪ o x ɐ s t̪ u 
Αφοσιώσεως	ɐ f o s i o s ɛ o s 
Αχαλίνωτου	ɐ x ɐ l i n̪ o t̪ u 
Βασίλισσας	v ɐ s i l i s ɐ s 
Βασιλόπουλ	v ɐ s i l o p u l 
Βγαίνοντας	v ɣ ɛ n̪ o d̪ ɐ s 
Δασαρχείου	ð ɐ s ɐ ɾ x i u 
Ειδικότερα	i ð i k o t̪ ɛ ɾ ɐ 
Ειρηνούλας	i ɾ i n̪ u l ɐ s 
Εξοχότατος	ɛ k s o x o t̪ ɐ t̪ o s 
Ινστιτούτο	i n̪ s t̪ i t̪ u t̪ o 
Κακομοίρης	k ɐ k o m i ɾ i s 
Κηρύσσουμε	k i ɾ i s u m ɛ 
Κοιμήθηκαν	k i m i θ i k ɐ n̪ 
Κουκόπουλο	k u k o p u l o 
Κυβερνήτες	k i v ɛ ɾ n̪ i t̪ ɛ s 
Κυβερνήτης	k i v ɛ ɾ n̪ i t̪ i s 
Λαγόκαρδος	l ɐ ɣ o k ɐ ɾ ð o s 
Λαγόκαρδου	l ɐ ɣ o k ɐ ɾ ð u 
Μισόκλεισε	m i s o k l i s ɛ 
Ξαναγύρισε	k s ɐ n̪ ɐ ɣ i ɾ i s ɛ 
Ξεκουράσου	k s ɛ k u ɾ ɐ s u 
Παλατιανός	p ɐ l ɐ t̪ i ɐ n̪ o s 
Πανουργάκο	p ɐ n̪ u ɾ ɣ ɐ k o 
Περπάτησαν	p ɛ ɾ p ɐ t̪ i s ɐ n̪ 
Πικρόχολης	p i k ɾ o x o l i s 
Πληγωμένος	p l i ɣ o m ɛ n̪ o s 
Πολύκαρπος	p o l i k ɐ ɾ p o s 
Πολύκαρπου	p o l i k ɐ ɾ p u 
Πουλημένος	p u l i m ɛ n̪ o s 
Προσπάθησε	p ɾ o s p ɐ θ i s ɛ 
Προχώρησαν	p ɾ o x o ɾ i s ɐ n̪ 
Σοβαρότατα	s o v ɐ ɾ o t̪ ɐ t̪ ɐ 
Σταμάτησαν	s t̪ ɐ m ɐ t̪ i s ɐ n̪ 
Στολίζεται	s t̪ o l i z ɛ t̪ ɛ 
Στουππαίων	s t̪ u p ɛ o n̪ 
Στρατιώτες	s t̪ ɾ ɐ t̪ i o t̪ ɛ s 
Ταραγμένος	t̪ ɐ ɾ ɐ ɣ m ɛ n̪ o s 
Τρελάθηκαν	t̪ ɾ ɛ l ɐ θ i k ɐ n̪ 
Φοβιτσιάρη	f o v i t̪ s i ɐ ɾ i 
Χαιρέτησαν	x ɛ ɾ ɛ t̪ i s ɐ n̪ 
Χαμηλώνεις	x ɐ m i l o n̪ i s 
Χαμογέλασε	x ɐ m o ɣ ɛ l ɐ s ɛ 
Χρειάζεται	x ɾ i ɐ z ɛ t̪ ɛ 
αγανάκτηση	ɐ ɣ ɐ n̪ ɐ k t̪ i s i 
αγορίστικο	ɐ ɣ o ɾ i s t̪ i k o 
αγριεμένες	ɐ ɣ ɾ i ɛ m ɛ n̪ ɛ s 
αγριόπαπια	ɐ ɣ ɾ i o p ɐ p i ɐ 
αγριόπουλα	ɐ ɣ ɾ i o p u l ɐ 
αγριόπουλο	ɐ ɣ ɾ i o p u l o 
αγριόχορτα	ɐ ɣ ɾ i o x o ɾ t̪ ɐ 
αδιάβατους	ɐ ð i ɐ v ɐ t̪ u s 
αηδιασμένο	ɐ i ð i ɐ s m ɛ n̪ o 
αιματωμένο	ɛ m ɐ t̪ o m ɛ n̪ o 
αισθάνθηκε	ɛ s θ ɐ n̪ θ i k ɛ 
αισθανόταν	ɛ s θ ɐ n̪ o t̪ ɐ n̪ 
ακατάδεκτη	ɐ k ɐ t̪ ɐ ð ɛ k t̪ i 
ακατάστατο	ɐ k ɐ t̪ ɐ s t̪ ɐ t̪ o 
ακολουθούν	ɐ k o l u θ u n̪ 
ακολούθησα	ɐ k o l u θ i s ɐ 
ακολούθησε	ɐ k o l u θ i s ɛ 
ακούγοντας	ɐ k u ɣ o d̪ ɐ s 
ακούουνταν	ɐ k u d̪ ɐ n̪ 
ακούστηκαν	ɐ k u s t̪ i k ɐ n̪ 
ακρολιμνιά	ɐ k ɾ o l i m n̪ i ɐ 
αλητόπαιδα	ɐ l i t̪ o p ɛ ð ɐ 
αλλάζοντας	ɐ l ɐ z o d̪ ɐ s 
αλλοιώσεις	ɐ l i o s i s 
αναίσθητος	ɐ n̪ ɛ s θ i t̪ o s 
αναγέννηση	ɐ n̪ ɐ ɣ ɛ n̪ n̪ i s i 
αναγκάζουν	ɐ n̪ ɐ ɡ ɐ z u n̪ 
αναγνώρισε	ɐ n̪ ɐ ɣ n̪ o ɾ i s ɛ 
αναδασωτέα	ɐ n̪ ɐ ð ɐ s o t̪ ɛ ɐ 
αναζήτησης	ɐ n̪ ɐ z i t̪ i s i s 
ανακούφιση	ɐ n̪ ɐ k u f i s i 
αναπληρώσω	ɐ n̪ ɐ p l i ɾ o s o 
αναρρωτική	ɐ n̪ ɐ ɾ o t̪ i k i 
αναστέναξε	ɐ n̪ ɐ s t̪ ɛ n̪ ɐ k s ɛ 
ανεκτίμητη	ɐ n̪ ɛ k t̪ i m i t̪ i 
ανενόχλητα	ɐ n̪ ɛ n̪ o x l i t̪ ɐ 
ανοίγοντας	ɐ n̪ i ɣ o d̪ ɐ s 
αντίστοιχα	ɐ d̪ i s t̪ i x ɐ 
ανταλλάξει	ɐ d̪ ɐ l ɐ k s i 
αντιδρούσε	ɐ d̪ i ð ɾ u s ɛ 
αντικρινής	ɐ d̪ i k ɾ i n̪ i s 
αντισταθεί	ɐ d̪ i s t̪ ɐ θ i 
αντρίκειες	ɐ d̪ ɾ i k i ɛ s 
απέραντους	ɐ p ɛ ɾ ɐ d̪ u s 
απαντήσαμε	ɐ p ɐ d̪ i s ɐ m ɛ 
απαντήσεις	ɐ p ɐ d̪ i s i s 
απαραίτητη	ɐ p ɐ ɾ ɛ t̪ i t̪ i 
απαραίτητο	ɐ p ɐ ɾ ɛ t̪ i t̪ o 
απεναντίας	ɐ p ɛ n̪ ɐ d̪ i ɐ s 
απλώνονται	ɐ p l o n̪ o d̪ ɛ 
απλώνοντας	ɐ p l o n̪ o d̪ ɐ s 
αποκρίθηκε	ɐ p o k ɾ i θ i k ɛ 
αποκτήσουν	ɐ p o k t̪ i s u n̪ 
απολαύσεις	ɐ p o l ɐ f s i s 
απομάκρυνε	ɐ p o m ɐ k ɾ i n̪ ɛ 
απορημένος	ɐ p o ɾ i m ɛ n̪ o s 
απουσιάζει	ɐ p u s i ɐ z i 
αποφασίσει	ɐ p o f ɐ s i s i 
αρπάζοντας	ɐ ɾ p ɐ z o d̪ ɐ s 
αρρωστήσει	ɐ ɾ o s t̪ i s i 
αρχικελάρη	ɐ ɾ x i k ɛ l ɐ ɾ i 
ασυνήθιστο	ɐ s i n̪ i θ i s t̪ o 
ασυνείδητο	ɐ s i n̪ i ð i t̪ o 
ατέλειωτες	ɐ t̪ ɛ l i o t̪ ɛ s 
αφρισμένος	ɐ f ɾ i s m ɛ n̪ o s 
βαλανιδιάς	v ɐ l ɐ n̪ i ð i ɐ s 
βασιλιάδες	v ɐ s i l i ɐ ð ɛ s 
βασιλικούς	v ɐ s i l i k u s 
βατομουριά	v ɐ t̪ o m u ɾ i ɐ 
βγαίνοντας	v ɣ ɛ n̪ o d̪ ɐ s 
βεβαιωθείς	v ɛ v ɛ o θ i s 
βεβαιωθούν	v ɛ v ɛ o θ u n̪ 
βιολογικοί	v i o l o ɣ i k i 
βιολογικών	v i o l o ɣ i k o n̪ 
βιωματικής	v i o m ɐ t̪ i k i s 
βλαστήμησε	v l ɐ s t̪ i m i s ɛ 
βουρκωμένα	v u ɾ k o m ɛ n̪ ɐ 
βρίσκονται	v ɾ i s k o d̪ ɛ 
βροντόφωνα	v ɾ o d̪ o f o n̪ ɐ 
γειτονικού	ɣ i t̪ o n̪ i k u 
γεματούλες	ɣ ɛ m ɐ t̪ u l ɛ s 
γονατιστός	ɣ o n̪ ɐ t̪ i s t̪ o s 
γουρλωμένα	ɣ u ɾ l o m ɛ n̪ ɐ 
γραμματέας	ɣ ɾ ɐ m ɐ t̪ ɛ ɐ s 
γραμματεία	ɣ ɾ ɐ m ɐ t̪ i ɐ 
γραμματείς	ɣ ɾ ɐ m ɐ t̪ i s 
γυαλιστερά	ɣ i ɐ l i s t̪ ɛ ɾ ɐ 
γυναικείες	ɣ i n̪ ɛ k i ɛ s 
γυρίζοντας	ɣ i ɾ i z o d̪ ɐ s 
γυρεύοντας	ɣ i ɾ ɛ v o d̪ ɐ s 
δείχνοντας	ð i x n̪ o d̪ ɐ s 
δειλιάσεις	ð i l i ɐ s i s 
δεξιότητες	ð ɛ k s i o t̪ i t̪ ɛ s 
δημοσίευσή	ð i m o s i ɛ f s i 
διαδρόμους	ð i ɐ ð ɾ o m u s 
διακονιάρη	ð i ɐ k o n̪ i ɐ ɾ i 
διακρίνουν	ð i ɐ k ɾ i n̪ u n̪ 
διακριτικά	ð i ɐ k ɾ i t̪ i k ɐ 
διαμαντικά	ð i ɐ m ɐ d̪ i k ɐ 
διαμόρφωση	ð i ɐ m o ɾ f o s i 
διαπίστωσε	ð i ɐ p i s t̪ o s ɛ 
διασκέδαση	ð i ɐ s k ɛ ð ɐ s i 
διευθύνεις	ð i ɛ f θ i n̪ i s 
διηγήθηκαν	ð i ɣ i θ i k ɐ n̪ 
διηγούνταν	ð i ɣ u d̪ ɐ n̪ 
δικαιοσύνη	ð i k ɛ o s i n̪ i 
δικαστήρια	ð i k ɐ s t̪ i ɾ i ɐ 
δικαστήριο	ð i k ɐ s t̪ i ɾ i o 
διοικήσεις	ð i k i s i s 
διπλοχέρης	ð i p l o x ɛ ɾ i s 
διπλώνομαι	ð i p l o n̪ o m ɛ 
διστακτικά	ð i s t̪ ɐ k t̪ i k ɐ 
δισταχτικά	ð i s t̪ ɐ x t̪ i k ɐ 
δοκιμάσεις	ð o k i m ɐ s i s 
δουλέψουμε	ð u l ɛ p s u m ɛ 
δυνατότερο	ð i n̪ ɐ t̪ o t̪ ɛ ɾ o 
δυνατότητα	ð i n̪ ɐ t̪ o t̪ i t̪ ɐ 
εμπειρικής	ɛ b i ɾ i k i s 
εμποδίσεις	ɛ b o ð i s i s 
ενθουσίασε	ɛ n̪ θ u s i ɐ s ɛ 
εξατμιστεί	ɛ k s ɐ t̪ m i s t̪ i 
εξαφανίσου	ɛ k s ɐ f ɐ n̪ i s u 
εξοχότατου	ɛ k s o x o t̪ ɐ t̪ u 
επανάσταση	ɛ p ɐ n̪ ɐ s t̪ ɐ s i 
επανέλαβαν	ɛ p ɐ n̪ ɛ l ɐ v ɐ n̪ 
επιβλήθηκε	ɛ p i v l i θ i k ɛ 
επιστρέψει	ɛ p i s t̪ ɾ ɛ p s i 
επιτακτικά	ɛ p i t̪ ɐ k t̪ i k ɐ 
επιτακτικό	ɛ p i t̪ ɐ k t̪ i k o 
εργοστάσιο	ɛ ɾ ɣ o s t̪ ɐ s i o 
ερειπωμένο	ɛ ɾ i p o m ɛ n̪ o 
εσταμάτησε	ɛ s t̪ ɐ m ɐ t̪ i s ɛ 
ευαίσθητοι	ɛ v ɛ s θ i t̪ i 
ζαλισμένος	z ɐ l i s m ɛ n̪ o s 
ζεσταθούμε	z ɛ s t̪ ɐ θ u m ɛ 
ζευγαρώσει	z ɛ v ɣ ɐ ɾ o s i 
ημερεμένος	i m ɛ ɾ ɛ m ɛ n̪ o s 
ημερομηνία	i m ɛ ɾ o m i n̪ i ɐ 
θλίβουνταν	θ l i v u d̪ ɐ n̪ 
ιδιαίτερες	i ð i ɛ t̪ ɛ ɾ ɛ s 
καβαλίκεψε	k ɐ v ɐ l i k ɛ p s ɛ 
καβαλαρέοι	k ɐ v ɐ l ɐ ɾ ɛ i 
καθησύχαζε	k ɐ θ i s i x ɐ z ɛ 
καθησύχασε	k ɐ θ i s i x ɐ s ɛ 
καθισμένοι	k ɐ θ i s m ɛ n̪ i 
καθισμένος	k ɐ θ i s m ɛ n̪ o s 
καινούριες	k ɛ n̪ u ɾ i ɛ s 
κακιωμένος	k ɐ k i o m ɛ n̪ o s 
κακομοίρης	k ɐ k o m i ɾ i s 
κακούργους	k ɐ k u ɾ ɣ u s 
καλαμιώνες	k ɐ l ɐ m i o n̪ ɛ s 
καλαμπόκια	k ɐ l ɐ b o k i ɐ 
καλντερίμι	k ɐ l d̪ ɛ ɾ i m i 
καλοπέραση	k ɐ l o p ɛ ɾ ɐ s i 
κανονίσομε	k ɐ n̪ o n̪ i s o m ɛ 
καπουτσίνο	k ɐ p u t̪ s i n̪ o 
καραγκιόζη	k ɐ ɾ ɐ ɡ i o z i 
καρτερούσε	k ɐ ɾ t̪ ɛ ɾ u s ɛ 
κατέβαιναν	k ɐ t̪ ɛ v ɛ n̪ ɐ n̪ 
καταγραφές	k ɐ t̪ ɐ ɣ ɾ ɐ f ɛ s 
καταδίκασε	k ɐ t̪ ɐ ð i k ɐ s ɛ 
καταλάβεις	k ɐ t̪ ɐ l ɐ v i s 
καταραμένο	k ɐ t̪ ɐ ɾ ɐ m ɛ n̪ o 
κατεβαίνει	k ɐ t̪ ɛ v ɛ n̪ i 
κατευθείαν	k ɐ t̪ ɛ f θ i ɐ n̪ 
κατεύθυνση	k ɐ t̪ ɛ f θ i n̪ s i 
κατρακύλια	k ɐ t̪ ɾ ɐ k i l i ɐ 
κατσαρόλες	k ɐ t̪ s ɐ ɾ o l ɛ s 
κείτουνταν	k i t̪ u d̪ ɐ n̪ 
κεντράρισε	k ɛ d̪ ɾ ɐ ɾ i s ɛ 
κερδισμένο	k ɛ ɾ ð i s m ɛ n̪ o 
κλεισμένος	k l i s m ɛ n̪ o s 
κλονίστηκε	k l o n̪ i s t̪ i k ɛ 
κλονούμενα	k l o n̪ u m ɛ n̪ ɐ 
κοιμηθούμε	k i m i θ u m ɛ 
κοιμισμένη	k i m i s m ɛ n̪ i 
κοιμούνταν	k i m u d̪ ɐ n̪ 
κοινωνικής	k i n̪ o n̪ i k i s 
κοκκίνιζαν	k o k i n̪ i z ɐ n̪ 
κολακεύεις	k o l ɐ k ɛ v i s 
κολυμπούσα	k o l i b u s ɐ 
κομμάτιαζε	k o m ɐ t̪ i ɐ z ɛ 
κορδώνεται	k o ɾ ð o n̪ ɛ t̪ ɛ 
κοροϊδεύει	k o ɾ o i ð ɛ v i 
κοτόπουλου	k o t̪ o p u l u 
κουβαλούσε	k u v ɐ l u s ɛ 
κουβούκλιο	k u v u k l i o 
κουδουνίζω	k u ð u n̪ i z o 
κουδούνιζε	k u ð u n̪ i z ɛ 
κουιούνταν	k u i u d̪ ɐ n̪ 
κουντουράς	k u d̪ u ɾ ɐ s 
κουρασμένα	k u ɾ ɐ s m ɛ n̪ ɐ 
κουραστική	k u ɾ ɐ s t̪ i k i 
κρέμουνταν	k ɾ ɛ m u d̪ ɐ n̪ 
κρεμάστηκε	k ɾ ɛ m ɐ s t̪ i k ɛ 
κρεμασμένα	k ɾ ɛ m ɐ s m ɛ n̪ ɐ 
κρεμασμένο	k ɾ ɛ m ɐ s m ɛ n̪ o 
κρεμαστάρι	k ɾ ɛ m ɐ s t̪ ɐ ɾ i 
κυλισμένος	k i l i s m ɛ n̪ o s 
κυρδάσκαλε	k i ɾ ð ɐ s k ɐ l ɛ 
λεονταράκι	l ɛ o d̪ ɐ ɾ ɐ k i 
λεωφορείου	l ɛ o f o ɾ i u 
λογαριασμό	l o ɣ ɐ ɾ i ɐ s m o 
λογχοφόροι	l o ɣ x o f o ɾ i 
λυγισμένος	l i ɣ i s m ɛ n̪ o s 
μαγείρεψες	m ɐ ɣ i ɾ ɛ p s ɛ s 
μαγείρισσα	m ɐ ɣ i ɾ i s ɐ 
μαγκωμένος	m ɐ ɡ o m ɛ n̪ o s 
μαζεύοντας	m ɐ z ɛ v o d̪ ɐ s 
μανιασμένη	m ɐ n̪ i ɐ s m ɛ n̪ i 
μασκαράδες	m ɐ s k ɐ ɾ ɐ ð ɛ s 
μεγιστάνας	m ɛ ɣ i s t̪ ɐ n̪ ɐ s 
μεγιστάνες	m ɛ ɣ i s t̪ ɐ n̪ ɛ s 
μελαγχολία	m ɛ l ɐ ɣ x o l i ɐ 
μερμηγκιών	m ɛ ɾ m i ɡ i o n̪ 
μεσημεριού	m ɛ s i m ɛ ɾ i u 
μεταλλείου	m ɛ t̪ ɐ l i u 
μετρήθηκαν	m ɛ t̪ ɾ i θ i k ɐ n̪ 
μισοέτοιμη	m i s o ɛ t̪ i m i 
μπακάλικου	b ɐ k ɐ l i k u 
μπερμπάντη	b ɛ ɾ b ɐ d̪ i 
μπορέσουμε	b o ɾ ɛ s u m ɛ 
μπορούσαμε	b o ɾ u s ɐ m ɛ 
ναύσταθμος	n̪ ɐ f s t̪ ɐ θ m o s 
νεραϊδούλα	n̪ ɛ ɾ ɐ i ð u l ɐ 
νεόφτιαστα	n̪ ɛ o f t̪ i ɐ s t̪ ɐ 
νοικοκύρης	n̪ i k o k i ɾ i s 
νομίζοντας	n̪ o m i z o d̪ ɐ s 
νοσοκομείο	n̪ o s o k o m i o 
νυσταγμένη	n̪ i s t̪ ɐ ɣ m ɛ n̪ i 
ξαναγίνουν	k s ɐ n̪ ɐ ɣ i n̪ u n̪ 
ξαναγύρισε	k s ɐ n̪ ɐ ɣ i ɾ i s ɛ 
ξανακάθισε	k s ɐ n̪ ɐ k ɐ θ i s ɛ 
ξανανέβηκε	k s ɐ n̪ ɐ n̪ ɛ v i k ɛ 
ξαναπέρασε	k s ɐ n̪ ɐ p ɛ ɾ ɐ s ɛ 
ξαναρχίσει	k s ɐ n̪ ɐ ɾ x i s i 
ξανασπούσε	k s ɐ n̪ ɐ s p u s ɛ 
ξαναφέρνει	k s ɐ n̪ ɐ f ɛ ɾ n̪ i 
ξαναφώναξε	k s ɐ n̪ ɐ f o n̪ ɐ k s ɛ 
ξαπλωμένος	k s ɐ p l o m ɛ n̪ o s 
ξαπλώθηκαν	k s ɐ p l o θ i k ɐ n̪ 
ξαφνίστηκε	k s ɐ f n̪ i s t̪ i k ɛ 
ξαφνισμένα	k s ɐ f n̪ i s m ɛ n̪ ɐ 
ξαφνισμένο	k s ɐ f n̪ i s m ɛ n̪ o 
ξεβραστούν	k s ɛ v ɾ ɐ s t̪ u n̪ 
ξεκάρδισμα	k s ɛ k ɐ ɾ ð i s m ɐ 
ξεκούφαναν	k s ɛ k u f ɐ n̪ ɐ n̪ 
ξενοδοχείο	k s ɛ n̪ o ð o x i o 
ξεπρόβαλαν	k s ɛ p ɾ o v ɐ l ɐ n̪ 
ξεπόρτισαν	k s ɛ p o ɾ t̪ i s ɐ n̪ 
ξεροψημένο	k s ɛ ɾ o p s i m ɛ n̪ o 
ξεστομίσει	k s ɛ s t̪ o m i s i 
ξεφυλλίζει	k s ɛ f i l i z i 
ξυλοπινάκα	k s i l o p i n̪ ɐ k ɐ 
οικογένεια	i k o ɣ ɛ n̪ i ɐ 
οικολογικά	i k o l o ɣ i k ɐ 
οικονομική	i k o n̪ o m i k i 
ολομόναχες	o l o m o n̪ ɐ x ɛ s 
ομολογήσει	o m o l o ɣ i s i 
οργανισμού	o ɾ ɣ ɐ n̪ i s m u 
οργισμένος	o ɾ ɣ i s m ɛ n̪ o s 
παίρνοντας	p ɛ ɾ n̪ o d̪ ɐ s 
παλατιανοί	p ɐ l ɐ t̪ i ɐ n̪ i 
παλατιανός	p ɐ l ɐ t̪ i ɐ n̪ o s 
παλιόπαιδο	p ɐ l i o p ɛ ð o 
παλιόσπιτο	p ɐ l i o s p i t̪ o 
παλιόχαρτα	p ɐ l i o x ɐ ɾ t̪ ɐ 
παντούφλες	p ɐ d̪ u f l ɛ s 
παράγγειλε	p ɐ ɾ ɐ ɡ i l ɛ 
παράγγελνε	p ɐ ɾ ɐ ɡ ɛ l n̪ ɛ 
παράδειγμα	p ɐ ɾ ɐ ð i ɣ m ɐ 
παρέχοντας	p ɐ ɾ ɛ x o d̪ ɐ s 
παρήγγειλε	p ɐ ɾ i ɡ i l ɛ 
παραγγελία	p ɐ ɾ ɐ ɡ ɛ l i ɐ 
παρακάλεσε	p ɐ ɾ ɐ k ɐ l ɛ s ɛ 
παραμέρισε	p ɐ ɾ ɐ m ɛ ɾ i s ɛ 
παραπάτησε	p ɐ ɾ ɐ p ɐ t̪ i s ɛ 
παρατήρησε	p ɐ ɾ ɐ t̪ i ɾ i s ɛ 
παρατήσεις	p ɐ ɾ ɐ t̪ i s i s 
παρατημένα	p ɐ ɾ ɐ t̪ i m ɛ n̪ ɐ 
παρατούσαν	p ɐ ɾ ɐ t̪ u s ɐ n̪ 
παρατώντας	p ɐ ɾ ɐ t̪ o d̪ ɐ s 
παραφέντης	p ɐ ɾ ɐ f ɛ d̪ i s 
παρουσίασε	p ɐ ɾ u s i ɐ s ɛ 
παστρευθεί	p ɐ s t̪ ɾ ɛ f θ i 
πείθουνταν	p i θ u d̪ ɐ n̪ 
πεθαμένους	p ɛ θ ɐ m ɛ n̪ u s 
πεινασμένα	p i n̪ ɐ s m ɛ n̪ ɐ 
πελεκηθούν	p ɛ l ɛ k i θ u n̪ 
περιέργεια	p ɛ ɾ i ɛ ɾ ɣ i ɐ 
περιβάλλον	p ɛ ɾ i v ɐ l o n̪ 
περιβολάκι	p ɛ ɾ i v o l ɐ k i 
περιγραφών	p ɛ ɾ i ɣ ɾ ɐ f o n̪ 
περιμένεις	p ɛ ɾ i m ɛ n̪ i s 
περιμένετε	p ɛ ɾ i m ɛ n̪ ɛ t̪ ɛ 
περιμένομε	p ɛ ɾ i m ɛ n̪ o m ɛ 
περιπέτεια	p ɛ ɾ i p ɛ t̪ i ɐ 
περπατούσε	p ɛ ɾ p ɐ t̪ u s ɛ 
πεταλούδες	p ɛ t̪ ɐ l u ð ɛ s 
πιαστήκαμε	p i ɐ s t̪ i k ɐ m ɛ 
πισθάγκωνα	p i s θ ɐ ɡ o n̪ ɐ 
πιστεύουμε	p i s t̪ ɛ v u m ɛ 
πληγώθηκες	p l i ɣ o θ i k ɛ s 
πλημμύριζε	p l i m i ɾ i z ɛ 
πλησιάσουν	p l i s i ɐ s u n̪ 
ποδοπατούν	p o ð o p ɐ t̪ u n̪ 
πολεμήσεις	p o l ɛ m i s i s 
πολεμήσουν	p o l ɛ m i s u n̪ 
πορτοκάλια	p o ɾ t̪ o k ɐ l i ɐ 
πουλήσουμε	p u l i s u m ɛ 
πουλούσαμε	p u l u s ɐ m ɛ 
πραγματικά	p ɾ ɐ ɣ m ɐ t̪ i k ɐ 
προκύπτουν	p ɾ o k i p t̪ u n̪ 
προλαβαίνω	p ɾ o l ɐ v ɛ n̪ o 
προμάντεμα	p ɾ o m ɐ d̪ ɛ m ɐ 
προσκόπους	p ɾ o s k o p u s 
προσπάθεια	p ɾ o s p ɐ θ i ɐ 
προσπάθησα	p ɾ o s p ɐ θ i s ɐ 
προσπάθησε	p ɾ o s p ɐ θ i s ɛ 
προτείνεις	p ɾ o t̪ i n̪ i s 
προφθάσομε	p ɾ o f θ ɐ s o m ɛ 
προχωρήσει	p ɾ o x o ɾ i s i 
πρωτεύουσα	p ɾ o t̪ ɛ v u s ɐ 
πρόφθαινες	p ɾ o f θ ɛ n̪ ɛ s 
ρουχάλιζαν	ɾ u x ɐ l i z ɐ n̪ 
σαστισμένα	s ɐ s t̪ i s m ɛ n̪ ɐ 
σαστισμένο	s ɐ s t̪ i s m ɛ n̪ o 
σηκώνοντας	s i k o n̪ o d̪ ɐ s 
σιμώνοντας	s i m o n̪ o d̪ ɐ s 
σκέπτονταν	s k ɛ p t̪ o d̪ ɐ n̪ 
σκαλίσουμε	s k ɐ l i s u m ɛ 
σκαλισμένο	s k ɐ l i s m ɛ n̪ o 
σκαλοπάτια	s k ɐ l o p ɐ t̪ i ɐ 
σκαρφάλωσε	s k ɐ ɾ f ɐ l o s ɛ 
σκεπασμένα	s k ɛ p ɐ s m ɛ n̪ ɐ 
σκεπασμένο	s k ɛ p ɐ s m ɛ n̪ o 
σκονισμένο	s k o n̪ i s m ɛ n̪ o 
σκορπίζουν	s k o ɾ p i z u n̪ 
σκορπούσαν	s k o ɾ p u s ɐ n̪ 
σκοτισμένο	s k o t̪ i s m ɛ n̪ o 
σκοτωθούμε	s k o t̪ o θ u m ɛ 
σουφρωμένα	s u f ɾ o m ɛ n̪ ɐ 
στέκουνταν	s t̪ ɛ k u d̪ ɐ n̪ 
σταμάτησαν	s t̪ ɐ m ɐ t̪ i s ɐ n̪ 
σταματήσει	s t̪ ɐ m ɐ t̪ i s i 
σταματούσε	s t̪ ɐ m ɐ t̪ u s ɛ 
σταυρωμένα	s t̪ ɐ v ɾ o m ɛ n̪ ɐ 
στενοχωρεί	s t̪ ɛ n̪ o x o ɾ i 
στολίστηκα	s t̪ o l i s t̪ i k ɐ 
στολισμένο	s t̪ o l i s m ɛ n̪ o 
στοχάστηκε	s t̪ o x ɐ s t̪ i k ɛ 
στρατιωτών	s t̪ ɾ ɐ t̪ i o t̪ o n̪ 
στρατιώτες	s t̪ ɾ ɐ t̪ i o t̪ ɛ s 
στρατιώτης	s t̪ ɾ ɐ t̪ i o t̪ i s 
στρατόπεδο	s t̪ ɾ ɐ t̪ o p ɛ ð o 
συζητούσαν	s i z i t̪ u s ɐ n̪ 
συλλογισμό	s i l o ɣ i s m o 
συμβαίνουν	s i m v ɛ n̪ u n̪ 
συμμαζέψει	s i m ɐ z ɛ p s i 
συμμαζεύει	s i m ɐ z ɛ v i 
συμμετάσχω	s i m ɛ t̪ ɐ s x o 
συμφέροντα	s i m f ɛ ɾ o d̪ ɐ 
συνάδελφος	s i n̪ ɐ ð ɛ l f o s 
συνέβαιναν	s i n̪ ɛ v ɛ n̪ ɐ n̪ 
συναγερμός	s i n̪ ɐ ɣ ɛ ɾ m o s 
συναδέλφων	s i n̪ ɐ ð ɛ l f o n̪ 
συναντήσει	s i n̪ ɐ d̪ i s i 
συνοδεύσει	s i n̪ o ð ɛ f s i 
συντροφικά	s i d̪ ɾ o f i k ɐ 
συντρόφους	s i d̪ ɾ o f u s 
σχετίζεται	s x ɛ t̪ i z ɛ t̪ ɛ 
σχετίζομαι	s x ɛ t̪ i z o m ɛ 
σωματάρχης	s o m ɐ t̪ ɐ ɾ x i s 
σωριάστηκε	s o ɾ i ɐ s t̪ i k ɛ 
ταράχθηκαν	t̪ ɐ ɾ ɐ x θ i k ɐ n̪ 
ταράχτηκαν	t̪ ɐ ɾ ɐ x t̪ i k ɐ n̪ 
ταραγμένος	t̪ ɐ ɾ ɐ ɣ m ɛ n̪ o s 
τελειωμένη	t̪ ɛ l i o m ɛ n̪ i 
τελειώνεις	t̪ ɛ l i o n̪ i s 
τελειώνουν	t̪ ɛ l i o n̪ u n̪ 
τελειώσεις	t̪ ɛ l i o s i s 
τελειώσουν	t̪ ɛ l i o s u n̪ 
τελευταίες	t̪ ɛ l ɛ f t̪ ɛ s 
τελευταίος	t̪ ɛ l ɛ f t̪ ɛ o s 
τεντωμένος	t̪ ɛ d̪ o m ɛ n̪ o s 
τηλεφωνήσω	t̪ i l ɛ f o n̪ i s o 
τιμωρήσεις	t̪ i m o ɾ i s i s 
τονίζοντας	t̪ o n̪ i z o d̪ ɐ s 
τοποθεσίας	t̪ o p o θ ɛ s i ɐ s 
τραβήχθηκε	t̪ ɾ ɐ v i x θ i k ɛ 
τραβηγμένο	t̪ ɾ ɐ v i ɣ m ɛ n̪ o 
τραπεζαρία	t̪ ɾ ɐ p ɛ z ɐ ɾ i ɐ 
τρομαγμένη	t̪ ɾ o m ɐ ɣ m ɛ n̪ i 
τρυπυμένες	t̪ ɾ i p i m ɛ n̪ ɛ s 
τσατιστούν	t̪ s ɐ t̪ i s t̪ u n̪ 
τυλιγμένος	t̪ i l i ɣ m ɛ n̪ o s 
τυποδέψουν	t̪ i p o ð ɛ p s u n̪ 
υπαγόρευσε	i p ɐ ɣ o ɾ ɛ f s ɛ 
υπαλλήλους	i p ɐ l i l u s 
υπασπιστές	i p ɐ s p i s t̪ ɛ s 
υπασπιστής	i p ɐ s p i s t̪ i s 
υποκλίθηκε	i p o k l i θ i k ɛ 
υπολογιστή	i p o l o ɣ i s t̪ i 
υποσχέθηκα	i p o s x ɛ θ i k ɐ 
υποχρεώνει	i p o x ɾ ɛ o n̪ i 
φαίνουνταν	f ɛ n̪ u d̪ ɐ n̪ 
φαντάζεσαι	f ɐ d̪ ɐ z ɛ s ɛ 
φανταχτερό	f ɐ d̪ ɐ x t̪ ɛ ɾ o 
φοβερίζεις	f o v ɛ ɾ i z i s 
φοβισμένος	f o v i s m ɛ n̪ o s 
φορτωμένος	f o ɾ t̪ o m ɛ n̪ o s 
φουντωμένο	f u d̪ o m ɛ n̪ o 
φουρτούνες	f u ɾ t̪ u n̪ ɛ s 
φουσκωμένο	f u s k o m ɛ n̪ o 
φροντίζομε	f ɾ o d̪ i z o m ɛ 
φροντίσουν	f ɾ o d̪ i s u n̪ 
φρούραρχος	f ɾ u ɾ ɐ ɾ x o s 
φτωχολογιά	f t̪ o x o l o ɣ i ɐ 
φτωχόπαιδο	f t̪ o x o p ɛ ð o 
φυλάγοντας	f i l ɐ ɣ o d̪ ɐ s 
φυλλαράκια	f i l ɐ ɾ ɐ k i ɐ 
φωνάζοντας	f o n̪ ɐ z o d̪ ɐ s 
φωτογραφία	f o t̪ o ɣ ɾ ɐ f i ɐ 
χαίρουνταν	x ɛ ɾ u d̪ ɐ n̪ 
χαιρετήσει	x ɛ ɾ ɛ t̪ i s i 
χαιρετισμό	x ɛ ɾ ɛ t̪ i s m o 
χαμηλότερα	x ɐ m i l o t̪ ɛ ɾ ɐ 
χαμηλόφωνα	x ɐ m i l o f o n̪ ɐ 
χαμογέλασε	x ɐ m o ɣ ɛ l ɐ s ɛ 
χαμόδεντρα	x ɐ m o ð ɛ d̪ ɾ ɐ 
χαρούμενος	x ɐ ɾ u m ɛ n̪ o s 
χειρότεροι	x i ɾ o t̪ ɛ ɾ i 
χειρότερος	x i ɾ o t̪ ɛ ɾ o s 
χρειάζεται	x ɾ i ɐ z ɛ t̪ ɛ 
χρειάζομαι	x ɾ i ɐ z o m ɛ 
χρειαζόταν	x ɾ i ɐ z o t̪ ɐ n̪ 
χρειαστείς	x ɾ i ɐ s t̪ i s 
χρωματιστό	x ɾ o m ɐ t̪ i s t̪ o 
χτίζουνταν	x t̪ i z u d̪ ɐ n̪ 
χωρίστηκαν	x o ɾ i s t̪ i k ɐ n̪ 
χωριουδάκι	x o ɾ i u ð ɐ k i 
Ακολουθείτε	ɐ k o l u θ i t̪ ɛ 
Αναγκάστηκε	ɐ n̪ ɐ ɡ ɐ s t̪ i k ɛ 
Ανασηκώθηκε	ɐ n̪ ɐ s i k o θ i k ɛ 
Αρειοπαγίτη	ɐ ɾ i o p ɐ ɣ i t̪ i 
Βασιλοπούλα	v ɐ s i l o p u l ɐ 
Βασιλόπουλο	v ɐ s i l o p u l o 
Ευλογημένος	ɛ v l o ɣ i m ɛ n̪ o s 
Κακομοιρίδη	k ɐ k o m i ɾ i ð i 
Κοροϊδεύεις	k o ɾ o i ð ɛ v i s 
Κουκουβάγια	k u k u v ɐ ɣ i ɐ 
Κυβερνήσεως	k i v ɛ ɾ n̪ i s ɛ o s 
Μοιρολάτρων	m i ɾ o l ɐ t̪ ɾ o n̪ 
Μοιρολατρών	m i ɾ o l ɐ t̪ ɾ o n̪ 
Μουρμούρισε	m u ɾ m u ɾ i s ɛ 
Ξαναχτύπησε	k s ɐ n̪ ɐ x t̪ i p i s ɛ 
Ονειρεύεσαι	o n̪ i ɾ ɛ v ɛ s ɛ 
Οποιαδήποτε	o p i ɐ ð i p o t̪ ɛ 
Παιδαγωγικό	p ɛ ð ɐ ɣ o ɣ i k o 
Παλιάνθρωπε	p ɐ l i ɐ n̪ θ ɾ o p ɛ 
Πανουργάκος	p ɐ n̪ u ɾ ɣ ɐ k o s 
Πανουργάκου	p ɐ n̪ u ɾ ɣ ɐ k u 
Παντελεήμων	p ɐ d̪ ɛ l ɛ i m o n̪ 
Παρατράβηξε	p ɐ ɾ ɐ t̪ ɾ ɐ v i k s ɛ 
Παρώνφώναξε	p ɐ ɾ o n̪ f o n̪ ɐ k s ɛ 
Περιμένουμε	p ɛ ɾ i m ɛ n̪ u m ɛ 
Πηγαίνοντας	p i ɣ ɛ n̪ o d̪ ɐ s 
Προσπαθούσε	p ɾ o s p ɐ θ u s ɛ 
Τουλάχιστον	t̪ u l ɐ x i s t̪ o n̪ 
Τρομαγμένοι	t̪ ɾ o m ɐ ɣ m ɛ n̪ i 
Τρομαγμένος	t̪ ɾ o m ɐ ɣ m ɛ n̪ o s 
Χαιρετήσετε	x ɛ ɾ ɛ t̪ i s ɛ t̪ ɛ 
Χρειάζονται	x ɾ i ɐ z o d̪ ɛ 
Χρειάστηκαν	x ɾ i ɐ s t̪ i k ɐ n̪ 
Χρησιμεύουν	x ɾ i s i m ɛ v u n̪ 
Χωροφύλακας	x o ɾ o f i l ɐ k ɐ s 
άκουσεςείπε	ɐ k u s ɛ s i p ɛ 
αγριόπαπιες	ɐ ɣ ɾ i o p ɐ p i ɛ s 
αισθάνθηκες	ɛ s θ ɐ n̪ θ i k ɛ s 
ακολουθήσει	ɐ k o l u θ i s i 
ακολουθούσε	ɐ k o l u θ u s ɛ 
ακολούθησαν	ɐ k o l u θ i s ɐ n̪ 
ακουμπήσεις	ɐ k u b i s i s 
ακροποταμιά	ɐ k ɾ o p o t̪ ɐ m i ɐ 
αλεπουδίσιο	ɐ l ɛ p u ð i s i o 
αναγέννησης	ɐ n̪ ɐ ɣ ɛ n̪ n̪ i s i s 
αναγνωρίζει	ɐ n̪ ɐ ɣ n̪ o ɾ i z i 
αναδασωτέας	ɐ n̪ ɐ ð ɐ s o t̪ ɛ ɐ s 
αναδεικνύει	ɐ n̪ ɐ ð i k n̪ i 
αναζητήσετε	ɐ n̪ ɐ z i t̪ i s ɛ t̪ ɛ 
αναπληρώσει	ɐ n̪ ɐ p l i ɾ o s i 
αναπόσπαστο	ɐ n̪ ɐ p o s p ɐ s t̪ o 
ανασηκώθηκε	ɐ n̪ ɐ s i k o θ i k ɛ 
αναστεναγμό	ɐ n̪ ɐ s t̪ ɛ n̪ ɐ ɣ m o 
ανατρίχιασε	ɐ n̪ ɐ t̪ ɾ i x i ɐ s ɛ 
ανεκπλήρωτη	ɐ n̪ ɛ k p l i ɾ o t̪ i 
ανταπόκριση	ɐ d̪ ɐ p o k ɾ i s i 
αντικείμενα	ɐ d̪ i k i m ɛ n̪ ɐ 
αντιλήφθηκε	ɐ d̪ i l i f θ i k ɛ 
αντιληφθούν	ɐ d̪ i l i f θ u n̪ 
αντρειωμένα	ɐ d̪ ɾ i o m ɛ n̪ ɐ 
αξιοθρήνητο	ɐ k s i o θ ɾ i n̪ i t̪ o 
αξιοπρέπεια	ɐ k s i o p ɾ ɛ p i ɐ 
αξιωματικοί	ɐ k s i o m ɐ t̪ i k i 
απαλλάξουμε	ɐ p ɐ l ɐ k s u m ɛ 
απαρηγόρητα	ɐ p ɐ ɾ i ɣ o ɾ i t̪ ɐ 
απελπισμένα	ɐ p ɛ l p i s m ɛ n̪ ɐ 
απεριποίητο	ɐ p ɛ ɾ i p i t̪ o 
απεσταλμένο	ɐ p ɛ s t̪ ɐ l m ɛ n̪ o 
απλώνουνταν	ɐ p l o n̪ u d̪ ɐ n̪ 
αποκλεισμός	ɐ p o k l i s m o s 
αποκοιμηθεί	ɐ p o k i m i θ i 
αποκρίθηκαν	ɐ p o k ɾ i θ i k ɐ n̪ 
αποκρίθηκες	ɐ p o k ɾ i θ i k ɛ s 
αποκρίνεται	ɐ p o k ɾ i n̪ ɛ t̪ ɛ 
απολογήθηκε	ɐ p o l o ɣ i θ i k ɛ 
αποτελέσουν	ɐ p o t̪ ɛ l ɛ s u n̪ 
αργοκούνησε	ɐ ɾ ɣ o k u n̪ i s ɛ 
αργοσαλεύει	ɐ ɾ ɣ o s ɐ l ɛ v i 
αρματωμένοι	ɐ ɾ m ɐ t̪ o m ɛ n̪ i 
αρχικελάρης	ɐ ɾ x i k ɛ l ɐ ɾ i s 
ασυλλόγιστα	ɐ s i l o ɣ i s t̪ ɐ 
αφανισμένος	ɐ f ɐ n̪ i s m ɛ n̪ o s 
βαρελόμορφη	v ɐ ɾ ɛ l o m o ɾ f i 
βασταγμένες	v ɐ s t̪ ɐ ɣ m ɛ n̪ ɛ s 
βαστιούνταν	v ɐ s t̪ i u d̪ ɐ n̪ 
βατομουριές	v ɐ t̪ o m u ɾ i ɛ s 
βουτηγμένος	v u t̪ i ɣ m ɛ n̪ o s 
βρίσκουνταν	v ɾ i s k u d̪ ɐ n̪ 
γαϊδουρίσιο	ɣ ɐ i ð u ɾ i s i o 
γεννιούνται	ɣ ɛ n̪ n̪ i u d̪ ɛ 
γκρεμίστηκε	ɡ ɾ ɛ m i s t̪ i k ɛ 
γκρεμισμένο	ɡ ɾ ɛ m i s m ɛ n̪ o 
γραμματάκια	ɣ ɾ ɐ m ɐ t̪ ɐ k i ɐ 
γραμματικής	ɣ ɾ ɐ m ɐ t̪ i k i s 
γρηγορώτερα	ɣ ɾ i ɣ o ɾ o t̪ ɛ ɾ ɐ 
γυμνασμένων	ɣ i m n̪ ɐ s m ɛ n̪ o n̪ 
δεσμοφύλακα	ð ɛ s m o f i l ɐ k ɐ 
δεσπόζοντας	ð ɛ s p o z o d̪ ɐ s 
δημιουργίας	ð i m i u ɾ ɣ i ɐ s 
διακόβοντας	ð i ɐ k o v o d̪ ɐ s 
διαμαντένια	ð i ɐ m ɐ d̪ ɛ n̪ i ɐ 
διαχείρισης	ð i ɐ x i ɾ i s i s 
διευθύνθηκε	ð i ɛ f θ i n̪ θ i k ɛ 
δικαιοσύνης	ð i k ɛ o s i n̪ i s 
δουλευτάδες	ð u l ɛ f t̪ ɐ ð ɛ s 
δουλεύοντας	ð u l ɛ v o d̪ ɐ s 
δυνατότερες	ð i n̪ ɐ t̪ o t̪ ɛ ɾ ɛ s 
δυσαρέσκεια	ð i s ɐ ɾ ɛ s k i ɐ 
εκατόνταρχο	ɛ k ɐ t̪ o d̪ ɐ ɾ x o 
εμπιστευθεί	ɛ b i s t̪ ɛ f θ i 
εμπιστοσύνη	ɛ b i s t̪ o s i n̪ i 
εναντιώθηκε	ɛ n̪ ɐ d̪ i o θ i k ɛ 
ενεργήσουμε	ɛ n̪ ɛ ɾ ɣ i s u m ɛ 
ενθουσιασμό	ɛ n̪ θ u s i ɐ s m o 
εξεταστικών	ɛ k s ɛ t̪ ɐ s t̪ i k o n̪ 
εξοργισμένο	ɛ k s o ɾ ɣ i s m ɛ n̪ o 
επαναλάβεις	ɛ p ɐ n̪ ɐ l ɐ v i s 
επιζητούσαν	ɛ p i z i t̪ u s ɐ n̪ 
επιστήμονες	ɛ p i s t̪ i m o n̪ ɛ s 
επιστρέψομε	ɛ p i s t̪ ɾ ɛ p s o m ɛ 
επιτήδειους	ɛ p i t̪ i ð i u s 
ετοιμάζεται	ɛ t̪ i m ɐ z ɛ t̪ ɛ 
ευχαρίστηση	ɛ f x ɐ ɾ i s t̪ i s i 
ζητιανεύεις	z i t̪ i ɐ n̪ ɛ v i s 
ζητιανεύουν	z i t̪ i ɐ n̪ ɛ v u n̪ 
θαυμάζοντας	θ ɐ v m ɐ z o d̪ ɐ s 
καβαλάρηδες	k ɐ v ɐ l ɐ ɾ i ð ɛ s 
καθυστέρηση	k ɐ θ i s t̪ ɛ ɾ i s i 
καινούριους	k ɛ n̪ u ɾ i u s 
κακορίζικοι	k ɐ k o ɾ i z i k i 
κακοριζικιά	k ɐ k o ɾ i z i k i ɐ 
καλημερίσει	k ɐ l i m ɛ ɾ i s i 
καλλιεργούν	k ɐ l i ɛ ɾ ɣ u n̪ 
καλοκαιριού	k ɐ l o k ɛ ɾ i u 
καπνίζοντας	k ɐ p n̪ i z o d̪ ɐ s 
καταγίνεσαι	k ɐ t̪ ɐ ɣ i n̪ ɛ s ɛ 
καταγίνεται	k ɐ t̪ ɐ ɣ i n̪ ɛ t̪ ɛ 
καταγγείλει	k ɐ t̪ ɐ ɡ i l i 
καταδέχεσαι	k ɐ t̪ ɐ ð ɛ x ɛ s ɛ 
καταδικάζει	k ɐ t̪ ɐ ð i k ɐ z i 
καταδικάσει	k ɐ t̪ ɐ ð i k ɐ s i 
κατακόκκινα	k ɐ t̪ ɐ k o k i n̪ ɐ 
κατακόκκινη	k ɐ t̪ ɐ k o k i n̪ i 
καταλάβαινε	k ɐ t̪ ɐ l ɐ v ɛ n̪ ɛ 
καταλαβαίνω	k ɐ t̪ ɐ l ɐ v ɛ n̪ o 
κατανάλωσης	k ɐ t̪ ɐ n̪ ɐ l o s i s 
καταστρέψει	k ɐ t̪ ɐ s t̪ ɾ ɛ p s i 
καταστραφεί	k ɐ t̪ ɐ s t̪ ɾ ɐ f i 
καταφθάνουν	k ɐ t̪ ɐ f θ ɐ n̪ u n̪ 
κατεβαίνουν	k ɐ t̪ ɛ v ɛ n̪ u n̪ 
κατοικημένη	k ɐ t̪ i k i m ɛ n̪ i 
κατρακύλησα	k ɐ t̪ ɾ ɐ k i l i s ɐ 
κατρακύλησε	k ɐ t̪ ɾ ɐ k i l i s ɛ 
καψουρευτεί	k ɐ p s u ɾ ɛ f t̪ i 
κινδυνεύουν	k i n̪ ð i n̪ ɛ v u n̪ 
κλεφτόπαιδο	k l ɛ f t̪ o p ɛ ð o 
κοιτάζοντας	k i t̪ ɐ z o d̪ ɐ s 
κολακευτικά	k o l ɐ k ɛ f t̪ i k ɐ 
κοροϊδεύεις	k o ɾ o i ð ɛ v i s 
κουβέντιαζε	k u v ɛ d̪ i ɐ z ɛ 
κουδούνισμα	k u ð u n̪ i s m ɐ 
κουκλίστικο	k u k l i s t̪ i k o 
κουλούριασε	k u l u ɾ i ɐ s ɛ 
κουνιούνταν	k u n̪ i u d̪ ɐ n̪ 
κουρέλιασμα	k u ɾ ɛ l i ɐ s m ɐ 
κουρασμένοι	k u ɾ ɐ s m ɛ n̪ i 
κουρασμένος	k u ɾ ɐ s m ɛ n̪ o s 
κρεμασμένος	k ɾ ɛ m ɐ s m ɛ n̪ o s 
κυβερνήσεις	k i v ɛ ɾ n̪ i s i s 
κυβερνήσετε	k i v ɛ ɾ n̪ i s ɛ t̪ ɛ 
λαχανόκηποι	l ɐ x ɐ n̪ o k i p i 
λαχανόκηπων	l ɐ x ɐ n̪ o k i p o n̪ 
μαρμαρωμένα	m ɐ ɾ m ɐ ɾ o m ɛ n̪ ɐ 
μαυρισμένες	m ɐ v ɾ i s m ɛ n̪ ɛ s 
μεγαλόπρεπη	m ɛ ɣ ɐ l o p ɾ ɛ p i 
μεγαλύτερον	m ɛ ɣ ɐ l i t̪ ɛ ɾ o n̪ 
μελαγχολικά	m ɛ l ɐ ɣ x o l i k ɐ 
μεταγγίσεις	m ɛ t̪ ɐ ɡ i s i s 
μετακομίσει	m ɛ t̪ ɐ k o m i s i 
μισοντυμένο	m i s o d̪ i m ɛ n̪ o 
μισοπιωμένο	m i s o p i o m ɛ n̪ o 
μουρμούριζε	m u ɾ m u ɾ i z ɛ 
μουρμούρισε	m u ɾ m u ɾ i s ɛ 
μουσαφιρέοι	m u s ɐ f i ɾ ɛ i 
μουφλούζεψε	m u f l u z ɛ p s ɛ 
μπαστουνάκι	b ɐ s t̪ u n̪ ɐ k i 
μπερδεύτηκε	b ɛ ɾ ð ɛ f t̪ i k ɛ 
μπερμπάντης	b ɛ ɾ b ɐ d̪ i s 
νοσηλεύτρια	n̪ o s i l ɛ f t̪ ɾ i ɐ 
ξανάβγαιναν	k s ɐ n̪ ɐ v ɣ ɛ n̪ ɐ n̪ 
ξαναγέμιζαν	k s ɐ n̪ ɐ ɣ ɛ m i z ɐ n̪ 
ξαναδίπλωσε	k s ɐ n̪ ɐ ð i p l o s ɛ 
ξαναθάρρεψε	k s ɐ n̪ ɐ θ ɐ ɾ ɛ p s ɛ 
ξαναχτίσεις	k s ɐ n̪ ɐ x t̪ i s i s 
ξαποστείλει	k s ɐ p o s t̪ i l i 
ξαφνισμένος	k s ɐ f n̪ i s m ɛ n̪ o s 
ξεκουραστεί	k s ɛ k u ɾ ɐ s t̪ i 
ξεμπερδέψει	k s ɛ b ɛ ɾ ð ɛ p s i 
ξεπετάχθηκε	k s ɛ p ɛ t̪ ɐ x θ i k ɛ 
ξεπληρώσετε	k s ɛ p l i ɾ o s ɛ t̪ ɛ 
ξεπορτίζεις	k s ɛ p o ɾ t̪ i z i s 
ξεφαντώματα	k s ɛ f ɐ d̪ o m ɐ t̪ ɐ 
ξεχειλούσαν	k s ɛ x i l u s ɐ n̪ 
ξεχρυσωμένο	k s ɛ x ɾ i s o m ɛ n̪ o 
οικονομικής	i k o n̪ o m i k i s 
ολομόναχους	o l o m o n̪ ɐ x u s 
ονειρεύεσαι	o n̪ i ɾ ɛ v ɛ s ɛ 
ονειρεύομαι	o n̪ i ɾ ɛ v o m ɛ 
ορθογραφίας	o ɾ θ o ɣ ɾ ɐ f i ɐ s 
παλατιανούς	p ɐ l ɐ t̪ i ɐ n̪ u s 
παπουτσάκια	p ɐ p u t̪ s ɐ k i ɐ 
παράβγαιναν	p ɐ ɾ ɐ v ɣ ɛ n̪ ɐ n̪ 
παραγγέλνει	p ɐ ɾ ɐ ɡ ɛ l n̪ i 
παραγγείλει	p ɐ ɾ ɐ ɡ i l i 
παραδέχομαι	p ɐ ɾ ɐ ð ɛ x o m ɛ 
παραμάγειρα	p ɐ ɾ ɐ m ɐ ɣ i ɾ ɐ 
παραμερίσει	p ɐ ɾ ɐ m ɛ ɾ i s i 
παρατήρησαν	p ɐ ɾ ɐ t̪ i ɾ i s ɐ n̪ 
παρατηρούσε	p ɐ ɾ ɐ t̪ i ɾ u s ɛ 
παρηγορήσει	p ɐ ɾ i ɣ o ɾ i s i 
πατρογονική	p ɐ t̪ ɾ o ɣ o n̪ i k i 
περιμένουμε	p ɛ ɾ i m ɛ n̪ u m ɛ 
περιπτώσεις	p ɛ ɾ i p t̪ o s i s 
περισσότερα	p ɛ ɾ i s o t̪ ɛ ɾ ɐ 
περισσότερη	p ɛ ɾ i s o t̪ ɛ ɾ i 
περισσότερο	p ɛ ɾ i s o t̪ ɛ ɾ o 
περιφερείας	p ɛ ɾ i f ɛ ɾ i ɐ s 
περιφράσεις	p ɛ ɾ i f ɾ ɐ s i s 
περιφρονείς	p ɛ ɾ i f ɾ o n̪ i s 
περιφρόνηση	p ɛ ɾ i f ɾ o n̪ i s i 
περπατησιές	p ɛ ɾ p ɐ t̪ i s i ɛ s 
περπατούσαν	p ɛ ɾ p ɐ t̪ u s ɐ n̪ 
περπατώντας	p ɛ ɾ p ɐ t̪ o d̪ ɐ s 
πηγαίνοντας	p i ɣ ɛ n̪ o d̪ ɐ s 
πιστοποίηση	p i s t̪ o p i s i 
πιτσιλώντας	p i t̪ s i l o d̪ ɐ s 
πληροφορίες	p l i ɾ o f o ɾ i ɛ s 
πορσελάνινη	p o ɾ s ɛ l ɐ n̪ i n̪ i 
προηγούμενη	p ɾ o i ɣ u m ɛ n̪ i 
προηγούμενο	p ɾ o i ɣ u m ɛ n̪ o 
προκαλείται	p ɾ o k ɐ l i t̪ ɛ 
προσβλητικό	p ɾ o s v l i t̪ i k o 
προσπάθησες	p ɾ o s p ɐ θ i s ɛ s 
προστακτικό	p ɾ o s t̪ ɐ k t̪ i k o 
προφέροντας	p ɾ o f ɛ ɾ o d̪ ɐ s 
προφθαίνεις	p ɾ o f θ ɛ n̪ i s 
προχωρήσουν	p ɾ o x o ɾ i s u n̪ 
ροδοκόκκινη	ɾ o ð o k o k i n̪ i 
σαπιοσάνιδα	s ɐ p i o s ɐ n̪ i ð ɐ 
σαστισμένες	s ɐ s t̪ i s m ɛ n̪ ɛ s 
σαστισμένοι	s ɐ s t̪ i s m ɛ n̪ i 
σαστισμένος	s ɐ s t̪ i s m ɛ n̪ o s 
σεκιουριτάς	s ɛ k i u ɾ i t̪ ɐ s 
σηκώνουνταν	s i k o n̪ u d̪ ɐ n̪ 
σκαρφάλωσαν	s k ɐ ɾ f ɐ l o s ɐ n̪ 
σκεπάζονταν	s k ɛ p ɐ z o d̪ ɐ n̪ 
σκεπάζοντας	s k ɛ p ɐ z o d̪ ɐ s 
σκονισμένος	s k o n̪ i s m ɛ n̪ o s 
σκορπισμένα	s k o ɾ p i s m ɛ n̪ ɐ 
σμαραγδένιο	s m ɐ ɾ ɐ ɣ ð ɛ n̪ i o 
σπρώχνοντας	s p ɾ o x n̪ o d̪ ɐ s 
σταματήσεις	s t̪ ɐ m ɐ t̪ i s i s 
σταματήσουν	s t̪ ɐ m ɐ t̪ i s u n̪ 
σταματώντας	s t̪ ɐ m ɐ t̪ o d̪ ɐ s 
στενοχώρεσε	s t̪ ɛ n̪ o x o ɾ ɛ s ɛ 
στηριγμένος	s t̪ i ɾ i ɣ m ɛ n̪ o s 
στραβοκάνης	s t̪ ɾ ɐ v o k ɐ n̪ i s 
στρατεύματα	s t̪ ɾ ɐ t̪ ɛ v m ɐ t̪ ɐ 
στρατιωτικά	s t̪ ɾ ɐ t̪ i o t̪ i k ɐ 
συγκινημένη	s i ɡ i n̪ i m ɛ n̪ i 
συγκρατήσει	s i ɡ ɾ ɐ t̪ i s i 
συγχωρήσεις	s i ɣ x o ɾ i s i s 
συλλογιέσαι	s i l o ɣ i ɛ s ɛ 
συλλογιστεί	s i l o ɣ i s t̪ i 
συμμαζέψουν	s i m ɐ z ɛ p s u n̪ 
συμμετάσχει	s i m ɛ t̪ ɐ s x i 
συνεννοηθεί	s i n̪ ɛ n̪ n̪ o i θ i 
συνεχίσουμε	s i n̪ ɛ x i s u m ɛ 
συνηθισμένα	s i n̪ i θ i s m ɛ n̪ ɐ 
συνηθισμένη	s i n̪ i θ i s m ɛ n̪ i 
συντηρητικά	s i d̪ i ɾ i t̪ i k ɐ 
συχωρεμένης	s i x o ɾ ɛ m ɛ n̪ i s 
σφανταχτερό	s f ɐ d̪ ɐ x t̪ ɛ ɾ o 
σφουγγοπάνα	s f u ɡ o p ɐ n̪ ɐ 
σχεδιασμούς	s x ɛ ð i ɐ s m u s 
ταπεινωμένο	t̪ ɐ p i n̪ o m ɛ n̪ o 
ταρακουνάει	t̪ ɐ ɾ ɐ k u n̪ ɐ i 
τελειώνουμε	t̪ ɛ l i o n̪ u m ɛ 
τενεκεδένια	t̪ ɛ n̪ ɛ k ɛ ð ɛ n̪ i ɐ 
τενεκεδένιο	t̪ ɛ n̪ ɛ k ɛ ð ɛ n̪ i o 
τηλεγραφική	t̪ i l ɛ ɣ ɾ ɐ f i k i 
τοπογραφικό	t̪ o p o ɣ ɾ ɐ f i k o 
τοποθέτησαν	t̪ o p o θ ɛ t̪ i s ɐ n̪ 
τουλάχιστον	t̪ u l ɐ x i s t̪ o n̪ 
τραγουδιστά	t̪ ɾ ɐ ɣ u ð i s t̪ ɐ 
τρανταχτερή	t̪ ɾ ɐ d̪ ɐ x t̪ ɛ ɾ i 
τρομαγμένες	t̪ ɾ o m ɐ ɣ m ɛ n̪ ɛ s 
τρομαγμένοι	t̪ ɾ o m ɐ ɣ m ɛ n̪ i 
τρομαγμένος	t̪ ɾ o m ɐ ɣ m ɛ n̪ o s 
τσουγκρανιά	t̪ s u ɡ ɾ ɐ n̪ i ɐ 
υπερηφάνεια	i p ɛ ɾ i f ɐ n̪ i ɐ 
υποκλίθηκες	i p o k l i θ i k ɛ s 
υπολογιστών	i p o l o ɣ i s t̪ o n̪ 
υπομονετικά	i p o m o n̪ ɛ t̪ i k ɐ 
υποστράτηγο	i p o s t̪ ɾ ɐ t̪ i ɣ o 
υποχρεώσεις	i p o x ɾ ɛ o s i s 
υποχρεώσεων	i p o x ɾ ɛ o s ɛ o n̪ 
φανταζόμουν	f ɐ d̪ ɐ z o m u n̪ 
φουρκισμένη	f u ɾ k i s m ɛ n̪ i 
φρουραρχείο	f ɾ u ɾ ɐ ɾ x i o 
φτερούγιζαν	f t̪ ɛ ɾ u ɣ i z ɐ n̪ 
χαιρετήσουν	x ɛ ɾ ɛ t̪ i s u n̪ 
χαιρετώντας	x ɛ ɾ ɛ t̪ o d̪ ɐ s 
χαμογέλασαν	x ɐ m o ɣ ɛ l ɐ s ɐ n̪ 
χαμογελάσει	x ɐ m o ɣ ɛ l ɐ s i 
χαμογελαστή	x ɐ m o ɣ ɛ l ɐ s t̪ i 
χαμογελούσε	x ɐ m o ɣ ɛ l u s ɛ 
χειρονομίες	x i ɾ o n̪ o m i ɛ s 
χειρότερους	x i ɾ o t̪ ɛ ɾ u s 
χοροπηδούσε	x o ɾ o p i ð u s ɛ 
χρησιμεύουν	x ɾ i s i m ɛ v u n̪ 
χρησιμεύσει	x ɾ i s i m ɛ f s i 
χτυπιούνταν	x t̪ i p i u d̪ ɐ n̪ 
χωροφύλακας	x o ɾ o f i l ɐ k ɐ s 
χωροφύλακες	x o ɾ o f i l ɐ k ɛ s 
ψιθυρίσματα	p s i θ i ɾ i s m ɐ t̪ ɐ 
Ακολουθήσετε	ɐ k o l u θ i s ɛ t̪ ɛ 
Αποχαιρέτησε	ɐ p o x ɛ ɾ ɛ t̪ i s ɛ 
Βασιλοπούλας	v ɐ s i l o p u l ɐ s 
Βασιλοπούλες	v ɐ s i l o p u l ɛ s 
Βασιλόπουλου	v ɐ s i l o p u l u 
Γκρεμιστείτε	ɡ ɾ ɛ m i s t̪ i t̪ ɛ 
Δυσκολευόταν	ð i s k o l ɛ v o t̪ ɐ n̪ 
Δυστυχόπουλο	ð i s t̪ i x o p u l o 
Κακομοιρίδης	k ɐ k o m i ɾ i ð i s 
Κατεργαρίσκο	k ɐ t̪ ɛ ɾ ɣ ɐ ɾ i s k o 
Κατρακυλάκος	k ɐ t̪ ɾ ɐ k i l ɐ k o s 
Μασκαρόπουλο	m ɐ s k ɐ ɾ o p u l o 
Μεγαλέμπορος	m ɛ ɣ ɐ l ɛ b o ɾ o s 
Μεγαλόσταυρο	m ɛ ɣ ɐ l o s t̪ ɐ v ɾ o 
Παραμάγειρας	p ɐ ɾ ɐ m ɐ ɣ i ɾ ɐ s 
Παραμερίσετε	p ɐ ɾ ɐ m ɛ ɾ i s ɛ t̪ ɛ 
Πρωτομάρτυρα	p ɾ o t̪ o m ɐ ɾ t̪ i ɾ ɐ 
Πρωτομάστορη	p ɾ o t̪ o m ɐ s t̪ o ɾ i 
Σαββατόβραδα	s ɐ v ɐ t̪ o v ɾ ɐ ð ɐ 
Συλλογίζομαι	s i l o ɣ i z o m ɛ 
Συλλογίστηκε	s i l o ɣ i s t̪ i k ɛ 
Ταλαιπωράκης	t̪ ɐ l ɛ p o ɾ ɐ k i s 
αγριοκάτσικα	ɐ ɣ ɾ i o k ɐ t̪ s i k ɐ 
αδιαφορώντας	ɐ ð i ɐ f o ɾ o d̪ ɐ s 
ακαλλιέργητο	ɐ k ɐ l i ɛ ɾ ɣ i t̪ o 
ακολουθήσαμε	ɐ k o l u θ i s ɐ m ɛ 
ακολουθήσομε	ɐ k o l u θ i s o m ɛ 
ακολουθήσουν	ɐ k o l u θ i s u n̪ 
ακολουθούσαν	ɐ k o l u θ u s ɐ n̪ 
ακολουθούσες	ɐ k o l u θ u s ɛ s 
ακολουθώντας	ɐ k o l u θ o d̪ ɐ s 
ακουμπισμένα	ɐ k u b i s m ɛ n̪ ɐ 
ακουμπισμένο	ɐ k u b i s m ɛ n̪ o 
αναγνωρίζεις	ɐ n̪ ɐ ɣ n̪ o ɾ i z i s 
αναγνωρίσετε	ɐ n̪ ɐ ɣ n̪ o ɾ i s ɛ t̪ ɛ 
ανακούρκουδα	ɐ n̪ ɐ k u ɾ k u ð ɐ 
αναμπαμπούλα	ɐ n̪ ɐ b ɐ b u l ɐ 
αναστατωμένη	ɐ n̪ ɐ s t̪ ɐ t̪ o m ɛ n̪ i 
αναστατώσετε	ɐ n̪ ɐ s t̪ ɐ t̪ o s ɛ t̪ ɛ 
ανατινάχθηκε	ɐ n̪ ɐ t̪ i n̪ ɐ x θ i k ɛ 
ανατρίχιασαν	ɐ n̪ ɐ t̪ ɾ i x i ɐ s ɐ n̪ 
ανεβαίνοντας	ɐ n̪ ɛ v ɛ n̪ o d̪ ɐ s 
ανεμπόδιστοι	ɐ n̪ ɛ b o ð i s t̪ i 
ανοιξιάτικος	ɐ n̪ i k s i ɐ t̪ i k o s 
ανοιχτόκαρδο	ɐ n̪ i x t̪ o k ɐ ɾ ð o 
ανταποδώσομε	ɐ d̪ ɐ p o ð o s o m ɛ 
αντικρίσουμε	ɐ d̪ i k ɾ i s u m ɛ 
ανυποψίαστοι	ɐ n̪ i p o p s i ɐ s t̪ i 
αξιοθρήνητος	ɐ k s i o θ ɾ i n̪ i t̪ o s 
αξιοποιηθούν	ɐ k s i o p i θ u n̪ 
αξιωματικούς	ɐ k s i o m ɐ t̪ i k u s 
απαρατήρητος	ɐ p ɐ ɾ ɐ t̪ i ɾ i t̪ o s 
απασχολημένη	ɐ p ɐ s x o l i m ɛ n̪ i 
απελπισμένος	ɐ p ɛ l p i s m ɛ n̪ o s 
απεσταλμένοι	ɐ p ɛ s t̪ ɐ l m ɛ n̪ i 
απεσταλμένου	ɐ p ɛ s t̪ ɐ l m ɛ n̪ u 
αποβλακωμένο	ɐ p o v l ɐ k o m ɛ n̪ o 
αποθαρρυμένο	ɐ p o θ ɐ ɾ i m ɛ n̪ o 
αποκαίουνταν	ɐ p o k ɛ u d̪ ɐ n̪ 
αποκαμωμένος	ɐ p o k ɐ m o m ɛ n̪ o s 
αποκατάσταση	ɐ p o k ɐ t̪ ɐ s t̪ ɐ s i 
αποκοιμήθηκε	ɐ p o k i m i θ i k ɛ 
απομακρυνθεί	ɐ p o m ɐ k ɾ i n̪ θ i 
αποτραβηχθεί	ɐ p o t̪ ɾ ɐ v i x θ i 
αποτραβηχτεί	ɐ p o t̪ ɾ ɐ v i x t̪ i 
αποφασιστικά	ɐ p o f ɐ s i s t̪ i k ɐ 
αποχαιρέτησε	ɐ p o x ɛ ɾ ɛ t̪ i s ɛ 
αποχαυνώσεως	ɐ p o x ɐ v n̪ o s ɛ o s 
αρχιστράτηγο	ɐ ɾ x i s t̪ ɾ ɐ t̪ i ɣ o 
αρχοντόπουλά	ɐ ɾ x o d̪ o p u l ɐ 
αρχοντόπουλα	ɐ ɾ x o d̪ o p u l ɐ 
αρχοντόπουλο	ɐ ɾ x o d̪ o p u l o 
βρεχτοκούκια	v ɾ ɛ x t̪ o k u k i ɐ 
βροντοφώνησε	v ɾ o d̪ o f o n̪ i s ɛ 
γλυκοχαράζει	ɣ l i k o x ɐ ɾ ɐ z i 
γονατίζοντας	ɣ o n̪ ɐ t̪ i z o d̪ ɐ s 
γονατισμένον	ɣ o n̪ ɐ t̪ i s m ɛ n̪ o n̪ 
γονατισμένου	ɣ o n̪ ɐ t̪ i s m ɛ n̪ u 
δαιμονισμένο	ð ɛ m o n̪ i s m ɛ n̪ o 
δεινοσαύρους	ð i n̪ o s ɐ v ɾ u s 
δεσμοφύλακας	ð ɛ s m o f i l ɐ k ɐ s 
δευτερόλεπτα	ð ɛ f t̪ ɛ ɾ o l ɛ p t̪ ɐ 
διαβάζουνταν	ð i ɐ v ɐ z u d̪ ɐ n̪ 
διαπιστώθηκε	ð i ɐ p i s t̪ o θ i k ɛ 
διασκεδάσεις	ð i ɐ s k ɛ ð ɐ s i s 
δροσίζουνταν	ð ɾ o s i z u d̪ ɐ n̪ 
δυσκολευόταν	ð i s k o l ɛ v o t̪ ɐ n̪ 
δυστυχισμένο	ð i s t̪ i x i s m ɛ n̪ o 
ειδοποιήσαμε	i ð o p i s ɐ m ɛ 
ειδοποιήσεις	i ð o p i s i s 
εκατόνταρχος	ɛ k ɐ t̪ o d̪ ɐ ɾ x o s 
εκπατριστείς	ɛ k p ɐ t̪ ɾ i s t̪ i s 
ελευθερώσεις	ɛ l ɛ f θ ɛ ɾ o s i s 
ελευθερώσουν	ɛ l ɛ f θ ɛ ɾ o s u n̪ 
εμπιστευθείς	ɛ b i s t̪ ɛ f θ i s 
εναλλακτικών	ɛ n̪ ɐ l ɐ k t̪ i k o n̪ 
ενθουσιασμός	ɛ n̪ θ u s i ɐ s m o s 
εξαγριωμένος	ɛ k s ɐ ɣ ɾ i o m ɛ n̪ o s 
εξακολουθείς	ɛ k s ɐ k o l u θ i s 
εξακολούθησε	ɛ k s ɐ k o l u θ i s ɛ 
εξαφανίστηκε	ɛ k s ɐ f ɐ n̪ i s t̪ i k ɛ 
εξοικειωθούν	ɛ k s i k i o θ u n̪ 
επιδιορθώσει	ɛ p i ð i o ɾ θ o s i 
επισκεφθείτε	ɛ p i s k ɛ f θ i t̪ ɛ 
επιφυλακτικά	ɛ p i f i l ɐ k t̪ i k ɐ 
ετοιμάζονταν	ɛ t̪ i m ɐ z o d̪ ɐ n̪ 
ευχαρίστησαν	ɛ f x ɐ ɾ i s t̪ i s ɐ n̪ 
ευχαριστηθεί	ɛ f x ɐ ɾ i s t̪ i θ i 
ευχαριστούμε	ɛ f x ɐ ɾ i s t̪ u m ɛ 
ζητιανόπαιδα	z i t̪ i ɐ n̪ o p ɛ ð ɐ 
ηλεκτρίστηκε	i l ɛ k t̪ ɾ i s t̪ i k ɛ 
θριαμβευτικά	θ ɾ i ɐ m v ɛ f t̪ i k ɐ 
κακοκαρδίσει	k ɐ k o k ɐ ɾ ð i s i 
κακοφαίνεται	k ɐ k o f ɛ n̪ ɛ t̪ ɛ 
καλλιέργειας	k ɐ l i ɛ ɾ ɣ i ɐ s 
καλοπιάσματα	k ɐ l o p i ɐ s m ɐ t̪ ɐ 
καταθλιμμένο	k ɐ t̪ ɐ θ l i m ɛ n̪ o 
κατακόκκινες	k ɐ t̪ ɐ k o k i n̪ ɛ s 
κατακόκκινος	k ɐ t̪ ɐ k o k i n̪ o s 
καταλαβαίνει	k ɐ t̪ ɐ l ɐ v ɛ n̪ i 
κατασκότεινο	k ɐ t̪ ɐ s k o t̪ i n̪ o 
καταστράφηκε	k ɐ t̪ ɐ s t̪ ɾ ɐ f i k ɛ 
καταστρέφουν	k ɐ t̪ ɐ s t̪ ɾ ɛ f u n̪ 
καταστρέψομε	k ɐ t̪ ɐ s t̪ ɾ ɛ p s o m ɛ 
καταφρονήσει	k ɐ t̪ ɐ f ɾ o n̪ i s i 
κατευθύνθηκε	k ɐ t̪ ɛ f θ i n̪ θ i k ɛ 
κατοικήσιμος	k ɐ t̪ i k i s i m o s 
κατρακυλιστά	k ɐ t̪ ɾ ɐ k i l i s t̪ ɐ 
κατρακυλούσε	k ɐ t̪ ɾ ɐ k i l u s ɛ 
κοντοστάθηκε	k o d̪ o s t̪ ɐ θ i k ɛ 
κοροϊδευτικά	k o ɾ o i ð ɛ f t̪ i k ɐ 
κουβέντιαζαν	k u v ɛ d̪ i ɐ z ɐ n̪ 
κρυσταλλένια	k ɾ i s t̪ ɐ l ɛ n̪ i ɐ 
λαχανιασμένο	l ɐ x ɐ n̪ i ɐ s m ɛ n̪ o 
λεπτομέρειες	l ɛ p t̪ o m ɛ ɾ i ɛ s 
λογαριασμούς	l o ɣ ɐ ɾ i ɐ s m u s 
λογαριαστείς	l o ɣ ɐ ɾ i ɐ s t̪ i s 
λυσσασμένους	l i s ɐ s m ɛ n̪ u s 
μακροβουτιού	m ɐ k ɾ o v u t̪ i u 
μετακινήθηκε	m ɛ t̪ ɐ k i n̪ i θ i k ɛ 
μετακινείται	m ɛ t̪ ɐ k i n̪ i t̪ ɛ 
μεταφέρθηκαν	m ɛ t̪ ɐ f ɛ ɾ θ i k ɐ n̪ 
μισοκρυμμένη	m i s o k ɾ i m ɛ n̪ i 
μισοξεραμένη	m i s o k s ɛ ɾ ɐ m ɛ n̪ i 
μισοπεθαμένο	m i s o p ɛ θ ɐ m ɛ n̪ o 
μισοσβησμένα	m i s o s v i s m ɛ n̪ ɐ 
μισοφαγωμένο	m i s o f ɐ ɣ o m ɛ n̪ o 
μονοκόμματος	m o n̪ o k o m ɐ t̪ o s 
μουδιασμένος	m u ð i ɐ s m ɛ n̪ o s 
μουρμούριζαν	m u ɾ m u ɾ i z ɐ n̪ 
μουρμούρισαν	m u ɾ m u ɾ i s ɐ n̪ 
μουρμούρισμα	m u ɾ m u ɾ i s m ɐ 
μουσαφίρηδες	m u s ɐ f i ɾ i ð ɛ s 
μουχλιασμένα	m u x l i ɐ s m ɛ n̪ ɐ 
νοικοκυρέους	n̪ i k o k i ɾ ɛ u s 
νοσηλεύτριες	n̪ o s i l ɛ f t̪ ɾ i ɛ s 
ξαναγυρίσουν	k s ɐ n̪ ɐ ɣ i ɾ i s u n̪ 
ξανακυριεύει	k s ɐ n̪ ɐ k i ɾ i ɛ v i 
ξαναπερνούσα	k s ɐ n̪ ɐ p ɛ ɾ n̪ u s ɐ 
ξαναπλησίασε	k s ɐ n̪ ɐ p l i s i ɐ s ɛ 
ξαναφτιάξεις	k s ɐ n̪ ɐ f t̪ i ɐ k s i s 
ξεγυαλισμένο	k s ɛ ɣ i ɐ l i s m ɛ n̪ o 
ξεθωριασμένο	k s ɛ θ o ɾ i ɐ s m ɛ n̪ o 
ξεκαρδίστηκε	k s ɛ k ɐ ɾ ð i s t̪ i k ɛ 
ξεκουφαίνεις	k s ɛ k u f ɛ n̪ i s 
ξελαφρωμένοι	k s ɛ l ɐ f ɾ o m ɛ n̪ i 
ξελαχανιάσει	k s ɛ l ɐ x ɐ n̪ i ɐ s i 
ξεμπαρκάρησε	k s ɛ b ɐ ɾ k ɐ ɾ i s ɛ 
ξεμπαρκάρομε	k s ɛ b ɐ ɾ k ɐ ɾ o m ɛ 
ξετρελαμένοι	k s ɛ t̪ ɾ ɛ l ɐ m ɛ n̪ i 
ξεφορτώθηκες	k s ɛ f o ɾ t̪ o θ i k ɛ s 
ολοκληρωμένο	o l o k l i ɾ o m ɛ n̪ o 
ορεκτικότατη	o ɾ ɛ k t̪ i k o t̪ ɐ t̪ i 
παιδαγωγικής	p ɛ ð ɐ ɣ o ɣ i k i s 
παντογνώστης	p ɐ d̪ o ɣ n̪ o s t̪ i s 
παραδείγματα	p ɐ ɾ ɐ ð i ɣ m ɐ t̪ ɐ 
παραισθήσεις	p ɐ ɾ ɛ s θ i s i s 
παρακαταθήκη	p ɐ ɾ ɐ k ɐ t̪ ɐ θ i k i 
παραμάγειρας	p ɐ ɾ ɐ m ɐ ɣ i ɾ ɐ s 
παραπεμπτικό	p ɐ ɾ ɐ p ɛ b t̪ i k o 
παραπονέθηκε	p ɐ ɾ ɐ p o n̪ ɛ θ i k ɛ 
παρατηρώντας	p ɐ ɾ ɐ t̪ i ɾ o d̪ ɐ s 
παρατραβήξει	p ɐ ɾ ɐ t̪ ɾ ɐ v i k s i 
παρενέργειες	p ɐ ɾ ɛ n̪ ɛ ɾ ɣ i ɛ s 
παρηγορήσεις	p ɐ ɾ i ɣ o ɾ i s i s 
πεινασμένους	p i n̪ ɐ s m ɛ n̪ u s 
περιβάλλοντα	p ɛ ɾ i v ɐ l o d̪ ɐ 
περιμένοντας	p ɛ ɾ i m ɛ n̪ o d̪ ɐ s 
πληκτρολογεί	p l i k t̪ ɾ o l o ɣ i 
πληκτρολόγιο	p l i k t̪ ɾ o l o ɣ i o 
προσεύχονται	p ɾ o s ɛ f x o d̪ ɛ 
προσκλητήριο	p ɾ o s k l i t̪ i ɾ i o 
προσπαθώντας	p ɾ o s p ɐ θ o d̪ ɐ s 
προστατεύσει	p ɾ o s t̪ ɐ t̪ ɛ f s i 
προσφέροντάς	p ɾ o s f ɛ ɾ o d̪ ɐ s 
προφυλαχθούν	p ɾ o f i l ɐ x θ u n̪ 
πρωτοβγαίναν	p ɾ o t̪ o v ɣ ɛ n̪ ɐ n̪ 
πρωτομάστορα	p ɾ o t̪ o m ɐ s t̪ o ɾ ɐ 
πρωτομάστορη	p ɾ o t̪ o m ɐ s t̪ o ɾ i 
πυροσβεστικό	p i ɾ o s v ɛ s t̪ i k o 
σερβιρισμένη	s ɛ ɾ v i ɾ i s m ɛ n̪ i 
σερβιρισμένο	s ɛ ɾ v i ɾ i s m ɛ n̪ o 
σιδερόπετρες	s i ð ɛ ɾ o p ɛ t̪ ɾ ɛ s 
σιδηρουργείο	s i ð i ɾ u ɾ ɣ i o 
σκεπάζουνταν	s k ɛ p ɐ z u d̪ ɐ n̪ 
σκορπίστηκαν	s k o ɾ p i s t̪ i k ɐ n̪ 
σκορπισμένες	s k o ɾ p i s m ɛ n̪ ɛ s 
σκουπίζοντας	s k u p i z o d̪ ɐ s 
σκουριασμένη	s k u ɾ i ɐ s m ɛ n̪ i 
σταυρώνοντας	s t̪ ɐ v ɾ o n̪ o d̪ ɐ s 
στραμπούληξε	s t̪ ɾ ɐ b u l i k s ɛ 
συγκεκριμένο	s i ɡ ɛ k ɾ i m ɛ n̪ o 
συγκινημένος	s i ɡ i n̪ i m ɛ n̪ o s 
συγκρατείται	s i ɡ ɾ ɐ t̪ i t̪ ɛ 
συλλογίζεσαι	s i l o ɣ i z ɛ s ɛ 
συλλογίζομαι	s i l o ɣ i z o m ɛ 
συλλογίστηκα	s i l o ɣ i s t̪ i k ɐ 
συλλογίστηκε	s i l o ɣ i s t̪ i k ɛ 
συλλογισμένα	s i l o ɣ i s m ɛ n̪ ɐ 
συλλογισμένη	s i l o ɣ i s m ɛ n̪ i 
συλλογισμένο	s i l o ɣ i s m ɛ n̪ o 
συλλογιστούν	s i l o ɣ i s t̪ u n̪ 
συνηθισμένοι	s i n̪ i θ i s m ɛ n̪ i 
συνοδεύονταν	s i n̪ o ð ɛ v o d̪ ɐ n̪ 
συνομιλούσαν	s i n̪ o m i l u s ɐ n̪ 
συντονίζεται	s i d̪ o n̪ i z ɛ t̪ ɛ 
συσκευασμένα	s i s k ɛ v ɐ s m ɛ n̪ ɐ 
τακτοποιήσει	t̪ ɐ k t̪ o p i s i 
τειχογύριζαν	t̪ i x o ɣ i ɾ i z ɐ n̪ 
τελετουργίες	t̪ ɛ l ɛ t̪ u ɾ ɣ i ɛ s 
τετραγωνάκια	t̪ ɛ t̪ ɾ ɐ ɣ o n̪ ɐ k i ɐ 
τετραγωνικών	t̪ ɛ t̪ ɾ ɐ ɣ o n̪ i k o n̪ 
τραγουδώντας	t̪ ɾ ɐ ɣ u ð o d̪ ɐ s 
τρεμουλιαστά	t̪ ɾ ɛ m u l i ɐ s t̪ ɐ 
τρεμουλιαστή	t̪ ɾ ɛ m u l i ɐ s t̪ i 
υποστράτηγος	i p o s t̪ ɾ ɐ t̪ i ɣ o s 
φαντασιώσεις	f ɐ d̪ ɐ s i o s i s 
φανταστικούς	f ɐ d̪ ɐ s t̪ i k u s 
φιλοξενήσουν	f i l o k s ɛ n̪ i s u n̪ 
φοβερίζοντας	f o v ɛ ɾ i z o d̪ ɐ s 
φουρκισμένος	f u ɾ k i s m ɛ n̪ o s 
φρενιασμένος	f ɾ ɛ n̪ i ɐ s m ɛ n̪ o s 
φρουραρχείου	f ɾ u ɾ ɐ ɾ x i u 
φτωχοντυμένο	f t̪ o x o d̪ i m ɛ n̪ o 
φυλακισμένοι	f i l ɐ k i s m ɛ n̪ i 
χαιρετίσματα	x ɛ ɾ ɛ t̪ i s m ɐ t̪ ɐ 
χαμογελώντας	x ɐ m o ɣ ɛ l o d̪ ɐ s 
χαρτοπετσέτα	x ɐ ɾ t̪ o p ɛ t̪ s ɛ t̪ ɐ 
χαχανίζοντας	x ɐ x ɐ n̪ i z o d̪ ɐ s 
χοροπηδούσαν	x o ɾ o p i ð u s ɐ n̪ 
χρειάζουνταν	x ɾ i ɐ z u d̪ ɐ n̪ 
χρειαζόμαστε	x ɾ i ɐ z o m ɐ s t̪ ɛ 
χρυσοκέντητο	x ɾ i s o k ɛ d̪ i t̪ o 
Αποχαιρέτησαν	ɐ p o x ɛ ɾ ɛ t̪ i s ɐ n̪ 
Διασκεδαστικά	ð i ɐ s k ɛ ð ɐ s t̪ i k ɐ 
Εξακολούθησαν	ɛ k s ɐ k o l u θ i s ɐ n̪ 
Επιστρέφοντας	ɛ p i s t̪ ɾ ɛ f o d̪ ɐ s 
Κατακοκκίνισε	k ɐ t̪ ɐ k o k i n̪ i s ɛ 
Καταλαβαίνεις	k ɐ t̪ ɐ l ɐ v ɛ n̪ i s 
Κατεργαρίσκος	k ɐ t̪ ɛ ɾ ɣ ɐ ɾ i s k o s 
Κλεπταποδόχος	k l ɛ p t̪ ɐ p o ð o x o s 
Κρυφοσκούπισε	k ɾ i f o s k u p i s ɛ 
Μασκαρόπουλου	m ɐ s k ɐ ɾ o p u l u 
Πανουργάκηδων	p ɐ n̪ u ɾ ɣ ɐ k i ð o n̪ 
Περιβάλλοντος	p ɛ ɾ i v ɐ l o d̪ o s 
Πληκτρολόγησε	p l i k t̪ ɾ o l o ɣ i s ɛ 
Πολυτρανότατε	p o l i t̪ ɾ ɐ n̪ o t̪ ɐ t̪ ɛ 
Στρίγλαφώναξε	s t̪ ɾ i ɣ l ɐ f o n̪ ɐ k s ɛ 
Συγκεντρώθηκε	s i ɡ ɛ d̪ ɾ o θ i k ɛ 
αγκαλιάζοντάς	ɐ ɡ ɐ l i ɐ z o d̪ ɐ s 
αγκαλιάζοντας	ɐ ɡ ɐ l i ɐ z o d̪ ɐ s 
αγριολούλουδα	ɐ ɣ ɾ i o l u l u ð ɐ 
αγριοφραουλιά	ɐ ɣ ɾ i o f ɾ ɐ u l i ɐ 
ακαλλιέργητες	ɐ k ɐ l i ɛ ɾ ɣ i t̪ ɛ s 
αλειμματοκέρι	ɐ l i m ɐ t̪ o k ɛ ɾ i 
αναγνωρισμένο	ɐ n̪ ɐ ɣ n̪ o ɾ i s m ɛ n̪ o 
ανακατώνοντας	ɐ n̪ ɐ k ɐ t̪ o n̪ o d̪ ɐ s 
αναποδογύρισε	ɐ n̪ ɐ p o ð o ɣ i ɾ i s ɛ 
αντεκδικήσεις	ɐ d̪ ɛ k ð i k i s i s 
αντικοινωνικά	ɐ d̪ i k i n̪ o n̪ i k ɐ 
αντιμετώπισης	ɐ d̪ i m ɛ t̪ o p i s i s 
απεικονίζεται	ɐ p i k o n̪ i z ɛ t̪ ɛ 
απελευθερώσει	ɐ p ɛ l ɛ f θ ɛ ɾ o s i 
απελπίζουνταν	ɐ p ɛ l p i z u d̪ ɐ n̪ 
αποθαρρυμένος	ɐ p o θ ɐ ɾ i m ɛ n̪ o s 
αποκοιμήθηκαν	ɐ p o k i m i θ i k ɐ n̪ 
αποκρίνουνταν	ɐ p o k ɾ i n̪ u d̪ ɐ n̪ 
αποχαιρέτησαν	ɐ p o x ɛ ɾ ɛ t̪ i s ɐ n̪ 
αποχαιρετήσει	ɐ p o x ɛ ɾ ɛ t̪ i s i 
αποχαιρετισμό	ɐ p o x ɛ ɾ ɛ t̪ i s m o 
αρχιμαστόρους	ɐ ɾ x i m ɐ s t̪ o ɾ u s 
αρχιστράτηγοι	ɐ ɾ x i s t̪ ɾ ɐ t̪ i ɣ i 
αρχιστράτηγος	ɐ ɾ x i s t̪ ɾ ɐ t̪ i ɣ o s 
αρχιστράτηγου	ɐ ɾ x i s t̪ ɾ ɐ t̪ i ɣ u 
βαριεστημένος	v ɐ ɾ i ɛ s t̪ i m ɛ n̪ o s 
διακατεχόμενη	ð i ɐ k ɐ t̪ ɛ x o m ɛ n̪ i 
διαπεραστικός	ð i ɐ p ɛ ɾ ɐ s t̪ i k o s 
διασκεδαστικά	ð i ɐ s k ɛ ð ɐ s t̪ i k ɐ 
διασκεδαστικό	ð i ɐ s k ɛ ð ɐ s t̪ i k o 
διοργανωθούμε	ð i o ɾ ɣ ɐ n̪ o θ u m ɛ 
δυστυχισμένον	ð i s t̪ i x i s m ɛ n̪ o n̪ 
δυστυχισμένος	ð i s t̪ i x i s m ɛ n̪ o s 
εκπαιδευτικής	ɛ k p ɛ ð ɛ f t̪ i k i s 
εμπιστεύθηκες	ɛ b i s t̪ ɛ f θ i k ɛ s 
ενθουσιάστηκε	ɛ n̪ θ u s i ɐ s t̪ i k ɛ 
ενθουσιασμένα	ɛ n̪ θ u s i ɐ s m ɛ n̪ ɐ 
ενθουσιασμένο	ɛ n̪ θ u s i ɐ s m ɛ n̪ o 
εξακολουθούσε	ɛ k s ɐ k o l u θ u s ɛ 
ετοιμάζουνταν	ɛ t̪ i m ɐ z u d̪ ɐ n̪ 
θριαμβευτικές	θ ɾ i ɐ m v ɛ f t̪ i k ɛ s 
κακοκαρδίζεις	k ɐ k o k ɐ ɾ ð i z i s 
καλοκαταλάβει	k ɐ l o k ɐ t̪ ɐ l ɐ v i 
καλοστρωμένοι	k ɐ l o s t̪ ɾ o m ɛ n̪ i 
καρποφορούσαν	k ɐ ɾ p o f o ɾ u s ɐ n̪ 
καρτοτηλέφωνα	k ɐ ɾ t̪ o t̪ i l ɛ f o n̪ ɐ 
καταγίνουνταν	k ɐ t̪ ɐ ɣ i n̪ u d̪ ɐ n̪ 
καταγραμμένοι	k ɐ t̪ ɐ ɣ ɾ ɐ m ɛ n̪ i 
καταδικασμένο	k ɐ t̪ ɐ ð i k ɐ s m ɛ n̪ o 
καταστρέφεται	k ɐ t̪ ɐ s t̪ ɾ ɛ f ɛ t̪ ɛ 
κατεβαίνοντας	k ɐ t̪ ɛ v ɛ n̪ o d̪ ɐ s 
κατρακυλούσαν	k ɐ t̪ ɾ ɐ k i l u s ɐ n̪ 
κιτρινιασμένα	k i t̪ ɾ i n̪ i ɐ s m ɛ n̪ ɐ 
κλεφταποδόχος	k l ɛ f t̪ ɐ p o ð o x o s 
κουδουνίσματα	k u ð u n̪ i s m ɐ t̪ ɐ 
κουρελιάρηδες	k u ɾ ɛ l i ɐ ɾ i ð ɛ s 
κουρελιασμένα	k u ɾ ɛ l i ɐ s m ɛ n̪ ɐ 
κουρελιασμένη	k u ɾ ɛ l i ɐ s m ɛ n̪ i 
κουρελιασμένο	k u ɾ ɛ l i ɐ s m ɛ n̪ o 
κρεβατοκάμαρα	k ɾ ɛ v ɐ t̪ o k ɐ m ɐ ɾ ɐ 
λαχανιασμένος	l ɐ x ɐ n̪ i ɐ s m ɛ n̪ o s 
μαντιλοδεμένο	m ɐ d̪ i l o ð ɛ m ɛ n̪ o 
μεγαλοπρέπεια	m ɛ ɣ ɐ l o p ɾ ɛ p i ɐ 
μικροενόχληση	m i k ɾ o ɛ n̪ o x l i s i 
μικροπρέπειες	m i k ɾ o p ɾ ɛ p i ɛ s 
μισοθυμωμένος	m i s o θ i m o m ɛ n̪ o s 
μισοπεθαμένος	m i s o p ɛ θ ɐ m ɛ n̪ o s 
μισορημαγμένα	m i s o ɾ i m ɐ ɣ m ɛ n̪ ɐ 
μπερμπάντηδες	b ɛ ɾ b ɐ d̪ i ð ɛ s 
ντροπιασμένος	d̪ ɾ o p i ɐ s m ɛ n̪ o s 
ξαναθυμούνταν	k s ɐ n̪ ɐ θ i m u d̪ ɐ n̪ 
ξανακατεβάσει	k s ɐ n̪ ɐ k ɐ t̪ ɛ v ɐ s i 
ξανανταμώσεις	k s ɐ n̪ ɐ d̪ ɐ m o s i s 
ξαναφτιάσουμε	k s ɐ n̪ ɐ f t̪ i ɐ s u m ɛ 
ξεθωριασμένες	k s ɛ θ o ɾ i ɐ s m ɛ n̪ ɛ s 
ξεκαρδίστηκαν	k s ɛ k ɐ ɾ ð i s t̪ i k ɐ n̪ 
ξεκαρδισμένοι	k s ɛ k ɐ ɾ ð i s m ɛ n̪ i 
ξεκαρδισμένος	k s ɛ k ɐ ɾ ð i s m ɛ n̪ o s 
ξεκουραστείτε	k s ɛ k u ɾ ɐ s t̪ i t̪ ɛ 
ξεκουραστούμε	k s ɛ k u ɾ ɐ s t̪ u m ɛ 
ξεμπερδεύτηκε	k s ɛ b ɛ ɾ ð ɛ f t̪ i k ɛ 
ξεσπαθώνοντας	k s ɛ s p ɐ θ o n̪ o d̪ ɐ s 
ολοστρόγγυλος	o l o s t̪ ɾ o ɡ i l o s 
παλιοσέντουκα	p ɐ l i o s ɛ d̪ u k ɐ 
παλιοφελούκες	p ɐ l i o f ɛ l u k ɛ s 
παραδέχουνταν	p ɐ ɾ ɐ ð ɛ x u d̪ ɐ n̪ 
παραδίνουνταν	p ɐ ɾ ɐ ð i n̪ u d̪ ɐ n̪ 
παρακολούθησε	p ɐ ɾ ɐ k o l u θ i s ɛ 
παραξενεύθηκα	p ɐ ɾ ɐ k s ɛ n̪ ɛ f θ i k ɐ 
παραπονιάρικα	p ɐ ɾ ɐ p o n̪ i ɐ ɾ i k ɐ 
παρουσιάζεται	p ɐ ɾ u s i ɐ z ɛ t̪ ɛ 
παρουσιάστηκε	p ɐ ɾ u s i ɐ s t̪ i k ɛ 
παρουσιαστείς	p ɐ ɾ u s i ɐ s t̪ i s 
περιβάλλοντος	p ɛ ɾ i v ɐ l o d̪ o s 
περιορίζονταν	p ɛ ɾ i o ɾ i z o d̪ ɐ n̪ 
περισσότερους	p ɛ ɾ i s o t̪ ɛ ɾ u s 
περιφρονητικά	p ɛ ɾ i f ɾ o n̪ i t̪ i k ɐ 
πιστοποιημένα	p i s t̪ o p i m ɛ n̪ ɐ 
πολυκατάστημα	p o l i k ɐ t̪ ɐ s t̪ i m ɐ 
πολυτρανότατε	p o l i t̪ ɾ ɐ n̪ o t̪ ɐ t̪ ɛ 
πρωτομάστορης	p ɾ o t̪ o m ɐ s t̪ o ɾ i s 
σηματοδοτήσει	s i m ɐ t̪ o ð o t̪ i s i 
σκανδαλισμένο	s k ɐ n̪ ð ɐ l i s m ɛ n̪ o 
σκοντάφτοντας	s k o d̪ ɐ f t̪ o d̪ ɐ s 
σκουντούφλησε	s k u d̪ u f l i s ɛ 
σπαραξικάρδιο	s p ɐ ɾ ɐ k s i k ɐ ɾ ð i o 
σπιθοβολούσαν	s p i θ o v o l u s ɐ n̪ 
στενοχωρέθηκε	s t̪ ɛ n̪ o x o ɾ ɛ θ i k ɛ 
στοιβάζουνταν	s t̪ i v ɐ z u d̪ ɐ n̪ 
συλλογίστηκες	s i l o ɣ i s t̪ i k ɛ s 
συλλογισμένος	s i l o ɣ i s m ɛ n̪ o s 
συμμαζεύοντας	s i m ɐ z ɛ v o d̪ ɐ s 
συννεφιασμένο	s i n̪ n̪ ɛ f i ɐ s m ɛ n̪ o 
συντεταγμένων	s i d̪ ɛ t̪ ɐ ɣ m ɛ n̪ o n̪ 
σχηματίζοντας	s x i m ɐ t̪ i z o d̪ ɐ s 
τρεμουλιάρικη	t̪ ɾ ɛ m u l i ɐ ɾ i k i 
τριανταφυλλιά	t̪ ɾ i ɐ d̪ ɐ f i l i ɐ 
τροποποιήθηκε	t̪ ɾ o p o p i θ i k ɛ 
υποστηρίζεται	i p o s t̪ i ɾ i z ɛ t̪ ɛ 
υποψιάζουνταν	i p o p s i ɐ z u d̪ ɐ n̪ 
χαμηλοπετούσε	x ɐ m i l o p ɛ t̪ u s ɛ 
χρυσοϋφασμένη	x ɾ i s o i f ɐ s m ɛ n̪ i 
Εξακολουθούσαν	ɛ k s ɐ k o l u θ u s ɐ n̪ 
Κουτρουβαλιστά	k u t̪ ɾ u v ɐ l i s t̪ ɐ 
Παραμερίζοντας	p ɐ ɾ ɐ m ɛ ɾ i z o d̪ ɐ s 
Σταυροκοπήθηκε	s t̪ ɐ v ɾ o k o p i θ i k ɛ 
Χειροκροτήματα	x i ɾ o k ɾ o t̪ i m ɐ t̪ ɐ 
Χρησιμοποιείτε	x ɾ i s i m o p i t̪ ɛ 
αγριοφραουλιές	ɐ ɣ ɾ i o f ɾ ɐ u l i ɛ s 
αναγνωρίζοντας	ɐ n̪ ɐ ɣ n̪ o ɾ i z o d̪ ɐ s 
ανασηκώνουνταν	ɐ n̪ ɐ s i k o n̪ u d̪ ɐ n̪ 
αναστενάζοντας	ɐ n̪ ɐ s t̪ ɛ n̪ ɐ z o d̪ ɐ s 
ανταποκρίνεται	ɐ d̪ ɐ p o k ɾ i n̪ ɛ t̪ ɛ 
αποχαιρετήσουν	ɐ p o x ɛ ɾ ɛ t̪ i s u n̪ 
αρχικαγκελάριο	ɐ ɾ x i k ɐ ɡ ɛ l ɐ ɾ i o 
αρχικαγκελάριό	ɐ ɾ x i k ɐ ɡ ɛ l ɐ ɾ i o 
αρχιτραπεζιέρη	ɐ ɾ x i t̪ ɾ ɐ p ɛ z i ɛ ɾ i 
αχτινοβολούσαν	ɐ x t̪ i n̪ o v o l u s ɐ n̪ 
διαμαρτυρήθηκε	ð i ɐ m ɐ ɾ t̪ i ɾ i θ i k ɛ 
δικαιολογήθηκε	ð i k ɛ o l o ɣ i θ i k ɛ 
δυσαρεστημένος	ð i s ɐ ɾ ɛ s t̪ i m ɛ n̪ o s 
εξακολουθούσαν	ɛ k s ɐ k o l u θ u s ɐ n̪ 
εξακολουθώντας	ɛ k s ɐ k o l u θ o d̪ ɐ s 
επικοινωνούσαν	ɛ p i k i n̪ o n̪ u s ɐ n̪ 
ευχαριστημένος	ɛ f x ɐ ɾ i s t̪ i m ɛ n̪ o s 
ικανοποιημένος	i k ɐ n̪ o p i m ɛ n̪ o s 
καθυστερημένες	k ɐ θ i s t̪ ɛ ɾ i m ɛ n̪ ɛ s 
καλλιεργητικών	k ɐ l i ɛ ɾ ɣ i t̪ i k o n̪ 
καλλιεργούσαμε	k ɐ l i ɛ ɾ ɣ u s ɐ m ɛ 
καλντεριμιτζού	k ɐ l d̪ ɛ ɾ i m i t̪ z u 
καταγραμμένους	k ɐ t̪ ɐ ɣ ɾ ɐ m ɛ n̪ u s 
καταχαρούμενοι	k ɐ t̪ ɐ x ɐ ɾ u m ɛ n̪ i 
καταχαρούμενος	k ɐ t̪ ɐ x ɐ ɾ u m ɛ n̪ o s 
κατσουφιασμένο	k ɐ t̪ s u f i ɐ s m ɛ n̪ o 
κουρελιασμένοι	k u ɾ ɛ l i ɐ s m ɛ n̪ i 
μεταμφιέζονται	m ɛ t̪ ɐ m f i ɛ z o d̪ ɛ 
μεταχειρίζεσαι	m ɛ t̪ ɐ x i ɾ i z ɛ s ɛ 
μεταχειρίστηκα	m ɛ t̪ ɐ x i ɾ i s t̪ i k ɐ 
μεταχειρισμένα	m ɛ t̪ ɐ x i ɾ i s m ɛ n̪ ɐ 
μεταχειριστείς	m ɛ t̪ ɐ x i ɾ i s t̪ i s 
μεταχειριστούν	m ɛ t̪ ɐ x i ɾ i s t̪ u n̪ 
μετεξελίσσεται	m ɛ t̪ ɛ k s ɛ l i s ɛ t̪ ɛ 
μισοξαπλωμένοι	m i s o k s ɐ p l o m ɛ n̪ i 
μισοχαρούμενος	m i s o x ɐ ɾ u m ɛ n̪ o s 
ξαναπαράγγελνε	k s ɐ n̪ ɐ p ɐ ɾ ɐ ɡ ɛ l n̪ ɛ 
ξετραχηλωμένες	k s ɛ t̪ ɾ ɐ x i l o m ɛ n̪ ɛ s 
παραζαλισμένοι	p ɐ ɾ ɐ z ɐ l i s m ɛ n̪ i 
παραζαλισμένος	p ɐ ɾ ɐ z ɐ l i s m ɛ n̪ o s 
παρακολουθήσει	p ɐ ɾ ɐ k o l u θ i s i 
παραμερίζοντας	p ɐ ɾ ɐ m ɛ ɾ i z o d̪ ɐ s 
παραξενεύθηκαν	p ɐ ɾ ɐ k s ɛ n̪ ɛ f θ i k ɐ n̪ 
πενηνταπεντάρα	p ɛ n̪ i d̪ ɐ p ɛ d̪ ɐ ɾ ɐ 
περιορίζουνταν	p ɛ ɾ i o ɾ i z u d̪ ɐ n̪ 
περισσευούμενα	p ɛ ɾ i s ɛ v u m ɛ n̪ ɐ 
πηγαινοέρχεται	p i ɣ ɛ n̪ o ɛ ɾ x ɛ t̪ ɛ 
προσδιορίζεται	p ɾ o s ð i o ɾ i z ɛ t̪ ɛ 
προστυχιάρηδες	p ɾ o s t̪ i x i ɐ ɾ i ð ɛ s 
προϋπολογισμού	p ɾ o i p o l o ɣ i s m u 
πρωτοβεστιάριο	p ɾ o t̪ o v ɛ s t̪ i ɐ ɾ i o 
σαρακοφαγωμένα	s ɐ ɾ ɐ k o f ɐ ɣ o m ɛ n̪ ɐ 
σκαρφαλώνοντας	s k ɐ ɾ f ɐ l o n̪ o d̪ ɐ s 
σκουντουφλήσει	s k u d̪ u f l i s i 
στενοχωρεμένος	s t̪ ɛ n̪ o x o ɾ ɛ m ɛ n̪ o s 
στενοχωρημένος	s t̪ ɛ n̪ o x o ɾ i m ɛ n̪ o s 
στρατοπέδευσαν	s t̪ ɾ ɐ t̪ o p ɛ ð ɛ f s ɐ n̪ 
στρεσαρισμένος	s t̪ ɾ ɛ s ɐ ɾ i s m ɛ n̪ o s 
συλλογίζουνταν	s i l o ɣ i z u d̪ ɐ n̪ 
συμπεριφέρεται	s i b ɛ ɾ i f ɛ ɾ ɛ t̪ ɛ 
τερματοφύλακας	t̪ ɛ ɾ m ɐ t̪ o f i l ɐ k ɐ s 
φτερουγίζοντας	f t̪ ɛ ɾ u ɣ i z o d̪ ɐ s 
χαρακτηριστικό	x ɐ ɾ ɐ k t̪ i ɾ i s t̪ i k o 
χημειοθεραπεία	x i m i o θ ɛ ɾ ɐ p i ɐ 
χρησιμοποιήσει	x ɾ i s i m o p i s i 
Χρησιμοποιώντας	x ɾ i s i m o p i o d̪ ɐ s 
αγουροξυπνημένο	ɐ ɣ u ɾ o k s i p n̪ i m ɛ n̪ o 
ανατριχιάζοντας	ɐ n̪ ɐ t̪ ɾ i x i ɐ z o d̪ ɐ s 
αρχικαγκελάριοι	ɐ ɾ x i k ɐ ɡ ɛ l ɐ ɾ i 
αρχικαγκελάριος	ɐ ɾ x i k ɐ ɡ ɛ l ɐ ɾ i o s 
αρχικαγκελάριου	ɐ ɾ x i k ɐ ɡ ɛ l ɐ ɾ i u 
καραγκιοζιλίκια	k ɐ ɾ ɐ ɡ i o z i l i k i ɐ 
κατασκονισμένος	k ɐ t̪ ɐ s k o n̪ i s m ɛ n̪ o s 
κατατρομαγμένου	k ɐ t̪ ɐ t̪ ɾ o m ɐ ɣ m ɛ n̪ u 
κατσουφιασμένες	k ɐ t̪ s u f i ɐ s m ɛ n̪ ɛ s 
κατσουφιασμένος	k ɐ t̪ s u f i ɐ s m ɛ n̪ o s 
κουβεντιάζοντας	k u v ɛ d̪ i ɐ z o d̪ ɐ s 
μουρμουρίζοντας	m u ɾ m u ɾ i z o d̪ ɐ s 
ξαναδιαλέγοντας	k s ɐ n̪ ɐ ð i ɐ l ɛ ɣ o d̪ ɐ s 
ξαναμαζεύουνταν	k s ɐ n̪ ɐ m ɐ z ɛ v u d̪ ɐ n̪ 
ονειροφορτωμένα	o n̪ i ɾ o f o ɾ t̪ o m ɛ n̪ ɐ 
παρακολουθήσουν	p ɐ ɾ ɐ k o l u θ i s u n̪ 
πατριώτεςρώτησε	p ɐ t̪ ɾ i o t̪ ɛ s ɾ o t̪ i s ɛ 
περιβαλλοντικής	p ɛ ɾ i v ɐ l o d̪ i k i s 
πηγαινοέρχονται	p i ɣ ɛ n̪ o ɛ ɾ x o d̪ ɛ 
πολλαπλασιαστεί	p o l ɐ p l ɐ s i ɐ s t̪ i 
πραγματοποιήσει	p ɾ ɐ ɣ m ɐ t̪ o p i s i 
πρωτοβεστιάριος	p ɾ o t̪ o v ɛ s t̪ i ɐ ɾ i o s 
πρωτοβεστιάριου	p ɾ o t̪ o v ɛ s t̪ i ɐ ɾ i u 
στραβομούτσουνα	s t̪ ɾ ɐ v o m u t̪ s u n̪ ɐ 
Διαμαντοστόλιστο	ð i ɐ m ɐ d̪ o s t̪ o l i s t̪ o 
Σχολείοαναφώνησε	s x o l i o ɐ n̪ ɐ f o n̪ i s ɛ 
επαναλαμβάνονται	ɛ p ɐ n̪ ɐ l ɐ m v ɐ n̪ o d̪ ɛ 
ευαισθητοποίησης	ɛ v ɛ s θ i t̪ o p i s i s 
καλοδιατηρημένος	k ɐ l o ð i ɐ t̪ i ɾ i m ɛ n̪ o s 
καρβουνιάζουνταν	k ɐ ɾ v u n̪ i ɐ z u d̪ ɐ n̪ 
κουτσοστέκουνταν	k u t̪ s o s t̪ ɛ k u d̪ ɐ n̪ 
μεταχειρίζουνταν	m ɛ t̪ ɐ x i ɾ i z u d̪ ɐ n̪ 
πανεροφορτωμένοι	p ɐ n̪ ɛ ɾ o f o ɾ t̪ o m ɛ n̪ i 
ξαναπαρουσιαστείς	k s ɐ n̪ ɐ p ɐ ɾ u s i ɐ s t̪ i s 
σκουντουφλιούνταν	s k u d̪ u f l i u d̪ ɐ n̪ 
κατακουρελιασμένος	k ɐ t̪ ɐ k u ɾ ɛ l i ɐ s m ɛ n̪ o s 
κυραρχικαγκελάριος	k i ɾ ɐ ɾ x i k ɐ ɡ ɛ l ɐ ɾ i o s 
παθολογοανατομικού	p ɐ θ o l o ɣ o ɐ n̪ ɐ t̪ o m i k u 
